كانداق=قانداق
يۇراك=يۈرەك
كەراك=كېرەك
سۇلغان=سۇلىغان
يوللاپسان=يوللاپسەن
كالدىم=كەلدىم
ئاسلى=ئەسلى
كاقۇرگىن=كەچۈرگىن
ناھخىسى=ناخشىسى
ئۇنىۋېرىستىت=ئۇنىۋېرسىتېت
بۇلامماي=بولالماي
توخكان=توشقان
قىرايلىك=چىرايلىق
گۇزال=گۈزەل
بىۋاپالىكىڭ=بىۋاپالىقىڭ
ھاتلىرىمنى=خەتلىرىمنى
تاخلىۋاتمىگىن=تاشلىۋەتمىگىن
كارا=قارا
كىمگا=كىمگە
خامال=شامال
ياخلىك=ياشلىق
سۇيەلمەيمەن=سۆيەلمەيمەن
سۇيگۇنۇم=سۆيگىنىم
تالمۇرىمەن=تەلمۈرىمەن
يوللۇغۇم=ياللۇغۇم
گىتتارىمنىڭ=گىتارىمنىڭ
لاياقىتىن=لاياقىتىم
ھوزۇرلانسا=ھۇزۇرلانسا
فرانسۇز=فىرانسۇز
ھوزۇرلىنىشىمىزغا=ھۇزۇرلىنىشىمىزغا
ھۇجۇدقا=ۋۇجۇدقا
سەۋاپ=سەۋەب
تەيارلانغانلىقى=تەييارلانغانلىقى
كىتاپخانلار=كىتابخانلار
ئۇقۇتۇپ=ئوقۇتۇپ
مۇتلەپ=مۇتلەق
چەكلەڭەندىن=چەكلەنگەندىن
يىغۋەلىش=يىغىۋېلىش
بۇلدۇرۇش=بىلدۈرۈش
تارقاتى=تارقاتتى
ژوڭخۇا=جۇڭخۇا
بەرۋاتقان=بېرىۋاتقان
چۇشۇنىشى=چۈشىنىشى
تەھتىتكە=تەھدىتكە
پەۋقۇلاتە=پەۋقۇلئاددە
مەدىنيىتىگە=مەدەنىيىتىگە
ئىنسانلىقا=ئىنسانلىققا
مۇاسىۋەت=مۇناسىۋەت
نەشىرىنىڭ=نەشرىنىڭ
سىۋىتىڭلارغا=سېۋىتىڭلارغا
توقۇز=توققۇز
سۆۋت=سېۋەت
دەپتو=دەپتۇ
تۇقۇم=تۇخۇم
تېخۇمدىن=تۇخۇمدىن
كۈرۈمسىرەپ=كۈلۈمسىرەپ
بىرىنسىپى=پىرىنسىپى
ئەسكەرتىتۇ=ئەسكەرتىدۇ
بايلىقا=بايلىققا
ئېقىنلادىن=ئېقىنلاردىن
ساقلامسا=ساقلانسا
ئۆزىنىڭكە=ئۆزىنىڭكى
ئاگرىپ=ئاغرىپ
ھەتا=ھەتتا
يېتىپتۈرىدۇ=يېتىلدۈرىدۇ
ئېسىڭدى=ئېسىڭدە
خەجىنىپ=خەجلىنىپ
كۇمپىسىنى=گۇمپىسىنى
گومپېنى=گۇمپىنى
يۆتكىش=يۆتكەش
ھىكاينى=ھېكايىنى
ئۆزگەرتىھكىە=ئۆزگەرتىشكە
بالىدۇ=بولىدۇ
باشقىرا=باشقىلا
بېرەك=دېرەك
قائىل=قايىل
بېرىتۇ=بېرىدۇ
نەۋادا=ناۋادا
تېخىچى=تېخىچە
قازانش=قازىنىش
كىرمى=كىرىمى
مۇھتتا=مۇھىتتا
تەربىيىلەشكە=تەربىيەلەشكە
قويمىدۇم=قويمىدىم
ئوبكان=ئوبدان
ئائىلىلەدە=ئائىلىلەردە
ئۆچنىسىگە=ئۆشنىسىگە
پراففېسسور=پروفېسسور
كۆپىنچىشىنىڭ=كۆپىنچىسىنىڭ
ھالاھىدە=ئالاھىدە
كىچىكىتىنلا=كىچىكىدىنلا
ئوخشىچىش=ئوخشىتىش
چاپقۇنىڭ=چاپقۇننىڭ
تەربىيىلەۋاتقان=تەربىيەلەۋاتقان
كۇتارمان=كۈتەرمەن
مۇھاببات=مۇھەببەت
پارىختام=پەرىشتەم
ناھخا=ناخشا
چۇخانمەدىڭ=چۈشەنمىدىڭ
دىسام=دېسەم
گوزال=گۈزەل
شارىتمىكان=شەرتمىكەن
شوھ=شوخ
پارزانت=پەرزەنت
ئاغىينە=ئاغىنە
ئانامكان=ئانامكەن
ھاسرىتى=ھەسرىتى
داردى=دەردى
بىلدىگمۇ=بىلدىڭمۇ
بىلمايدۇ=بىلمەيدۇ
بىلمايسان=بىلمەيسەن
ھاسرات=ھەسرەت
قاراكاش=قاراقاش
كىز=قىز
كالبى=قەلبى
چۇشۇمگا=چۈشۈمگە
كورالمىدىم=كۆرەلمىدىم
سىنى=سېنى
لاززىتى=لەززىتى
قولپانلىرىمىز=چولپانلىرىمىز
سۇيگۇ=سۆيگۈ
سۇيالامسان=سۆيەلەمسەن
تىلاك=تىلەك
تۇتكان=تۇتقان
بىكا=بىكار
يىھلامسان=يىغلامسەن
تۇرساگ=تۇرساڭ
باشكا=باشقا
ساۋاكداش=ساۋاقداش
نۇسكا=نۇسخا
لايلى=لەيلى
ئانامگا=ئانامغا
مۇمام=مومام
مۇزلىگان=مۇزلىغان
قەمبەرھان=قەمبەرخان
ھانلايلۇن=خانلەيلۇن
ئازىزىم=ئەزىزىم
سەبىلەرنى=سەبىيلەرنى
يىغلاتمۇ=يىغلاتما
سەگىنىمەن=سېغىنىمەن
شەپكەتلىك=شەپقەتلىك
بۇلايلى=بولايلى
شاماللارگا=شاماللارغا
ئۇنۇتالماسمەن=ئۇنىتالماسمەن
سىگمىدى=سىغمىدى
سۇيەلمىدىم=سۆيەلمىدىم
ئۇنۇتالمايسىز=ئۇنىتالمايسىز
يىگلايمەن=يىغلايمەن
يۇرەگىمنى=يۈرىكىمنى
بودۇم=بولدۇم
باھىت=بەخت
بەھىت=بەخت
بىھەۋەر=بىخەۋەر
بىلامسان=بىلەمسەن
ئەچىنىمان=ئېچىنىمەن
گاپ=گەپ
گۇلداستا=گۈلدەستە
گۇلىايىم=گۇلايىم
گۇزەلىك=گۈزەللىك
ئاداخ=ئاداش
ئىنتىزارمان=ئىنتىزارمەن
كالدىگلىمۇ=كەلدىلىمۇ
كىزلار=قىزلار
ياخلار=ياشلار
ئۇنتالمايسىز=ئۇنىتالمايسىز
ئاسلايمان=ئەسلەيمەن
كىقىلار=كېچىلەر
پىيالا=پىيالە
كۇياخىم=قۇياشىم
ساھرا=سەھرا
كىزى=قىزى
شۈكىرى=شۈكرى
سۇمبۇلە=سۇنبۇلە
ئۇنتاي=ئۇنىتاي
ئاتۇخ=ئاتۇش
دىمىساڭ=دېمىسەڭ
دىما=دېمە
دوسلىكىمىز=دوستلۇقىمىز
خاتىرا=خاتىرە
كويدۇرما=كۆيدۈرمە
ماڭگۇ=مەڭگۈ
ئولكام=ئۆلكەم
پارۋازىم=پەرۋازىم
دىگان=دېگەن
داريا=دەريا
ئاكىدۇ=ئاقىدۇ
ھاتنا=خەتنە
تەھى=تېخى
ياخ=ياش
نادانلىك=نادانلىق
ئۇقۇن=ئۈچۈن
خەىر=شېئىر
ياھخىلىك=ياخشىلىق
يوكتۇر=يوقتۇر
باھتىڭ=بەختىڭ
نادا=نەدە
بىللا=بىللە
تاغدىرىم=تەقدىرىم
كالمىدىڭ=كەلمىدىڭ
يىراك=يىراق
ئاسلىما=ئەسلىمە
ياشلىك=ياشلىق
بارمايمان=بارمايمەن
دايدۇ=دەيدۇ
پارىزات=پەرىزات
خاۋار=خەۋەر
كاش=قاش
كاتتىڭ=كەتتىڭ
كونالمىدىم=كۆنەلمىدىم
ياشاشكا=ياشاشقا
بالاگا=بالاغا
كورمىسام=كۆرمىسەم
ماھاللاڭگا=مەھەللەڭگە
كاتساڭ=كەتسەڭ
بولگان=بولغان
سەغىنىخ=سېغىنىش
سويگانتىم=سۆيگەنتىم
سۇيگۇنىگا=سۆيگىنىگە
تاگمىگان=تەگمىگەن
يىگلاتسا=يىغلاتسا
ئاگار=ئەگەر
ئۇزمۇدۇم=ئۈزمىدىم
ئۇياھتا=ئۇياقتا
يالغانقى=يالغانچى
نەملەڭەن=نەملەنگەن
بەبات=بەربات
قورقىتالمىغاچ=قورقۇتالمىغاچ
كېلىچىكىڭىز=كېلەچىكىڭىز
كىتاۋىنى=كىتابىنى
كەشمېر=كەشمىر
كامادىكى=كاماردىكى
كۆپچۈلۈككە=كۆپچىلىككە
كۆرۈنۈدۇ=كۆرۈنىدۇ
كاستىيوم=كاستۇم
كۆزۈتۈپ=كۆزىتىپ
كۆرۈدىغانلار=كۆرىدىغانلار
كۆرۈدۇ=كۆرىدۇ
كۈتۈپخانىلارمۇ=كۇتۇپخانىلارمۇ
كىتاپخانلارنى=كىتابخانلارنى
كېلاسسىك=كلاسسىك
كاكىراۋاتقان=كاركىراۋاتقان
كۈتۈپخانىسىدىمۇ=كۇتۇپخانىسىدىمۇ
كىتاپخانىغا=كىتابخانىغا
يەگى=يېڭى
خوشياقمايدۇ=خۇشياقمايدۇ
توساتىنلا=توساتتىنلا
ئاپېراتورى=ئوپېراتورى
بايانلانى=بايانلارنى
ئىدىيىۋى=ئىدىيەۋى
مىنزان=مىزان
ئۆزۈمۇ=ئۆزۈممۇ
بۇنچۇۋالا=بۇنچىۋالا
كارۋىتىڭنىڭ=كارىۋىتىڭنىڭ
مەڭۈ=مەڭگۈ
كىشىك=كىچىك
بەگىنىمگە=بەرگىنىمگە
بەمەكچىمەن=بەرمەكچىمەن
ئاڭلىماقا=ئاڭلىماققا
تۇيلۇپتۇ=تۇيۇلۇپتۇ
ئۇچراستىم=ئۇچراشتىم
ھوجرام=ھۇجرام
توساتتۇللا=توساتتىنلا
يوغام=يوغان
قىغىنىڭنىڭ=قىلغىنىڭنىڭ
يۈگۈرەممەيمىزغۇ=يۈگۈرەلمەيمىزغۇ
ئۆزگىرىشلەگە=ئۆزگىرىشلەرگە
يۈگۈرەممەسلىكىڭ=يۈگۈرەلمەسلىكىڭ
رىقابەتچىشىنىڭ=رىقابەتچىسىنىڭ
رەقىپلىرىڭ=رەقىبلىرىڭ
ئوغىرلاپ=ئوغرىلاپ
ئادەتلىنىۋاغىنىكەن=ئادەتلىنىۋالغانىكەن
بۇتۇلكىدىن=بوتۇلكىدىن
سايىپجامال=ساھىبجامال
ھوقۇقا=ھوقۇققا
ئوچراپ=ئۇچراپ
ئولتۇن=ئالتۇن
باقمىغىنىكەن=باقمىغانىكەن
مەنپەئەتىن=مەنپەئەتتىن
كۆڭلىڭ=كۆڭلۈڭ
ئېيتقىنىچى=ئېيتقىنىچە
خۇشاللىقا=خۇشاللىققا
ئۆشنىڭدىكى=ئۆشنەڭدىكى
ئېلىۋەسسەڭلا=ئېلىۋەتسەڭلا
ئۇشتۇلۇپ=ئوشتۇلۇپ
يۈركىم=يۈرىكىم
غېرىب-غۇرۋالاغا=غېرىب-غۇرۋالارغا
زىممىڭدە=زىممەڭدە
زىممىڭدىكى=زىممەڭدىكى
زىممىمگە=زىممەمگە
تېغىنىم=تېغىنىڭ
قاقلىغاش=قاقلىغاچ
پەلسەپسىدىن=پەلسەپىسىدىن
ئاداۋوكات=ئادۋوكات
كۆسىتىپ=كۆرسىتىپ
باسامماي=باسالماي
جاقىراپ=جارقىراپ
كانترول=كونترول
قىلامماي=قىلالماي
تاقى-تۇققۇ=تاققا-تۇققا
تاللىۋاغاندۇ=تاللىۋالغاندۇ
ئانچى=ئانچە
قىلاممىغاچقا=قىلالمىغاچقا
رەقىبلەگە=رەقىبلەرگە
بومماستىن=بولماستىن
مۇداپىئىدىكى=مۇداپىئەدىكى
قىلاممىغان=قىلالمىغان
بوشىتىۋاغىنى=بوشىتىۋالغىنى
پەيتلەگە=پەيتلەرگە
ئادەملەلا=ئادەملەرلا
يېغىشتۇرۇۋالالايدۇ=يىغىشتۇرۇۋالالايدۇ
تەربىيلىنىشى=تەربىيەلىنىشى
قوماندانلاچە=قوماندانلارچە
يۇمشىتقىلى=يۇمشاتقىلى
بوممىغۇر=بولمىغۇر
ئىش-ھەرىكەتلەنى=ئىش-ھەرىكەتلەرنى
بوغانلىرى=بولغانلىرى
ئىنتىزاملاغا=ئىنتىزاملارغا
قوۋىقىنى=قوۋۇقىنى
كېمەسازلىق=كېمىسازلىق
قىسقىراقا=قىسقىراقى
يۆتكەچكىمۇ=يۆتكەشكىمۇ
قاراپۇ=قاراپتۇ
پەرموننى=پەرماننى
زادا=زادى
سورىگىنىكەن=سورىغىنىكەن
ئافىلادىن=ئافىنادىن
تەكرالاپ=تەكرارلاپ
تۇرۇۋاپتى=تۇرۇۋاپتۇ
بەمەسلىك=بەرمەسلىك
غېرىشلاشقا=غېرىچلاشقا
ساھلاپ=ساقلاپ
ئۆمكۈرنىڭ=ئۆڭكۈرنىڭ
ئۆڭكۈل=ئۆڭكۈر
كۆرۈمىدىم=كۆرمىدىم
تىلكە=تۈلكە
مىلىشمال=مىلىچمال
دۇكۈنىنىڭ=دۇكىنىنىڭ
مىلىچمەنلار=مىلىچماللار
كېتىپتى=كېتىپتۇ
خارەكتىرىڭ=خاراكتېرىڭ
قويىۋدۇ=قويىدۇ
كۆڭلى-كۆكسە=كۆڭۈل-كۆكسى
مۇھىمە=مۇھىمى
تەڭۇرنىڭ=تەڭرىنىڭ
قىلىناكەن=قىلىناركەن
تېنىتماي=تېمىتماي
يەتقۈزۈپتۇ=يەتكۈزۈپتۇ
ئەخمەقلىقىغە=ئەخمەقلىقىگە
كېىپ=كېلىپ
خىيانىڭغىمۇ=خىيالىڭغىمۇ
قاانچە=قانچە
ئىنتىرىدۇ=ئىنتىلىدۇ
مەقسىدىڭنى=مەقسىتىڭنى
قىسقىغىنى=قىسقىغىنە
جىدىيلەشكەن=جىددىيلەشكەن
مۇلاھىزىلەنى=مۇلاھىزىلەرنى
ئېىپ=ئېلىپ
قىسقىغىن=قىسقىغىنە
كۆرىمىسەن=كۆرۈنىسەن
زەھەرخەنبە=زەھەرخەندە
تۆنۈشكە=تۆلەشكە
گرىكچە=گىرېكچە
ئەزلار=ئەزالار
تېرورىستلارنى=تېررورىستلارنى
ئىگەللىگەندە=ئىگىلىگەندە
پارتىيسى=پارتىيەسى
تەربىيىلەش=تەربىيەلەش
تېرورلۇقىدىن=تېررورلۇقىدىن
تېرورلۇقى=تېررورلۇقى
فرانسىيىدە=فىرانسىيەدە
ئىنقىلاۋا=ئىنقىلاب
مالامۇنچىلىقنىڭ=مالىمانچىلىقنىڭ
تېلەپ=تېنەپ
كۆررسىتىش=كۆرسىتىش
دېققات=دىققەت
ئابرويىڭ=ئابرۇيۇڭ
تېخىمى=تېخىمۇ
ساللىق=سانلىق
كاللېكتىپ=كوللېكتىپ
قاماشتۇرۇۋەت=قاماشتۇرۇۋات
قارتىش=قارىتىش
ئاۋادۇ=ئاغىدۇ
تەقدۈردىمۇ=تەقدىردىمۇ
ئېچكىم=ھېچكىم
فىلملارنى=فىلىملارنى
دۇنىيادىكى=دۇنيادىكى
كۈچ-قۇۋەت=كۈچ-قۇۋۋەت
ئاتقۇرالىسا=ئاقتۇرالىسا
قوشىدىغانلىغىغا=قوشىدىغانلىقىغا
تېخنولوگىياسى=تېخنولوگىيەسى
مۇھەرىرى=مۇھەررىرى
قەبىرسى=قەبرىسى
فرانسىيەدە=فىرانسىيەدە
ھىساپلىنىدىغان=ھېسابلىنىدىغان
شۇارلارغا=شوئارلارغا
ئۇنىۋېرىستىتىدا=ئۇنىۋېرسىتېتىدا
پروفېسسولار=پروفېسسورلار
يوقۇتۇشنى=يوقىتىشنى
زىيالىغا=زىيالىيغا
سىياسىيۇنغا=سىياسىيونغا
ياراشىتى=ياراشتى
رادىيوسىغا=رادىئوسىغا
مۇنەجىمنىڭ=مۇنەججىمنىڭ
مۇنەجىم=مۇنەججىم
مۇناجىمنى=مۇنەججىمنى
ماناجىم=مۇنەججىم
ئەسكەرلەگە=ئەسكەرلەرگە
مۇناججىم=مۇنەججىم
مۇنەجىمنى=مۇنەججىمنى
نەتىجەسى=نەتىجىسى
پادىشاھدىنمۇ=پادىشاھتىنمۇ
پېتىناممايدۇ=پېتىنالمايدۇ
ھېكايىدا=ھېكايىدە
قۇللانغان=قوللانغان
ھەشقانلا=ھەشقاللا
ناتايىم=ناتايىن
كۆۋرۈتتىن=كۆۋرۈكتىن
تەمسىمنىڭ=تەمسىلنىڭ
تاۋاملىق=داۋاملىق
مۇكىممەللەشتۈرۈپ=مۇكەممەللەشتۈرۈپ
باساممايدىغان=باسالمايدىغان
ئورنىڭ=ئورنۇڭ
تۈزۈگرەك=تۈزۈكرەك
شۇغۇلىناپتۇ=شۇغۇللىنىپتۇ
مەسىلىلەگە=مەسىلىلەرگە
چىرمىھان=چىرمىغان
كىرىزىسىغا=كرىزىسىغا
ئۇقۇملانى=ئۇقۇملارنى
مېھمانلاغا=مېھمانلارغا
جاققىدا=جاققىدە
نەرسىلەنى=نەرسىلەرنى
چىقادىڭ=چىقاردىڭ
جاھ=جاق
ئىلھاملانى=ئىلھاملارنى
ممىكىن=مومىكىن
بوغاندىلا=بولغاندىلا
كۆپۈنچى=كۆپىنچە
يۈرۈۋەسەك=يۈرۈۋەرسەك
ئۇچرۇشۇڭنىڭ=ئۇچرىشىڭنىڭ
ئوۋۇشلۇق=ئوڭۇشلۇق
ئوت-چۇپلەگە=ئوت-چۆپلەرگە
ئوت-چۇپلەرمۇ=ئوت-چۆپلەرمۇ
ئىتتىرىگەنلەر=ئىتتەرگەنلەر
بەكىللىك=ۋەكىللىك
كېتەممەيسەن=كېتەلمەيسەن
كەگەندە=كەلگەندە
بۇرۇنلىشنى=بۇرۇلۇشنى
بۇرۇنلايمۇ=بۇرۇلايمۇ
بۇرۇنمايمۇ=بۇرۇلمايمۇ
بەردەشلىق=بەرداشلىق
دېگەنلەنى=دېگەنلەرنى
كۆزىتەممەي=كۆزىتەلمەي
بولغىنۇم=بولغىنىم
بىلكى=بەلكى
سۆزلەنى=سۆزلەرنى
بوغىنىم=بولغىنىم
نەتىجىلەنى=نەتىجىلەرنى
بوساڭ=بولساڭ
ئادەملەنىڭ=ئادەملەرنىڭ
رېئانلىق=رېئاللىق
بولاممايدۇ=بولالمايدۇ
چىقاغان=چىقارغان
پاجىئەلەگە=پاجىئەلەرگە
جاھىللاچە=جاھىللارچە
قورسۇغۇڭ=قورسىقىڭ
تويامدا=تويامدۇ
بوممىسا=بولمىسا
كىشىلە=كىشىلەر
قورسۇغۇڭنى=قورسىقىڭنى
ئەزەمەت=ئەزىمەت
تىنناقلىرىدىن=تىرناقلىرىدىن
قۇتۇلاممايدۇ=قۇتۇلالمايدۇ
تاتمىسا=تارتمىسا
تاتمايدۇ=تارتمايدۇ
تاتىش=تارتىش
مەنپەئەتلەنى=مەنپەئەتلەرنى
بەزىلە=بەزىلەر
ئۈمۈر=ئۆمۈر
رۇسلىياممايدۇ=رۇسلىيالمايدۇ
بوسا=بولسا
ئېچىنىشلىك=ئېچىنىشلىق
لۆكچەك=لۈكچەك
بوغان=بولغان
قىممىغان=قىلمىغان
نۇسرەتلەنى=نۇسرەتلەرنى
بەسەك=بەرسەك
تەخسىماتتىن=تەقسىماتتىن
با=بار
پوچتاخانىغا=پوچتىخانىغا
بىرلەيلەن=بىرەيلەن
خوساللىق=خۇشاللىق
جۇغراپىيىلىك=جۇغراپىيەلىك
خەۋىپى=خەۋپى
ئىستراتېگىيىلىك=ئىستراتېگىيەلىك
ترامپ=تىرامپ
ھەپتىمدە=ھەپتەمدە
ترامپقا=تىرامپقا
ئەكسس=ئەكس
روسىيەنىڭ=رۇسىيەنىڭ
سودالا=سودىلا
ترامپنىڭ=تىرامپنىڭ
روسىيەنى=رۇسىيەنى
تۆھپىم=تۆھپەم
ۋاشىنگىتونغا=ۋاشىنگتونغا
ئويىمنى=ئويۇمنى
ترامپمۇ=تىرامپمۇ
ترامپنى=تىرامپنى
مېخانىزمىم=مېخانىزمى
كۇمىنداڭ=گومىنداڭ
ئەنگىلىيەنى=ئەنگلىيەنى
ئەنگىلىيەدىن=ئەنگلىيەدىن
تىۋىتتىر=تىۋىتتېر
تىۋىتتىردا=تىۋىتتېردا
بىئولوگىيىلىك=بىئولوگىيەلىك
خىمىيىلىك=خىمىيەلىك
تەھدىدنىڭ=تەھدىتنىڭ
دېزىنفىنسىيە=دېزىنفېكسىيە
ئالساڭقۇ=ئالساڭچۇ
تاققۇ-تۇققۇ=تاققا-تۇققا
كوگلۇم=كۆڭلۈم
باخكىدا=باشقىدا
گۋلى=گۈلى
يىگىرمىنجى=يىگىرمىنچى
پەقەتلى=پەقەتلا
ئۆسەنمەپتۇ=ئۆسەلمەپتۇ
شىنىڭ=شۇنىڭ
بالىقىنى=بارلىقىنى
ئەمىسى=ئەمىسە
بوممايدىغان=بولمايدىغان
ھادىسى=ھادىسە
كۈچۈن=كۈچۈم
بوممايدۇ=بولمايدۇ
كەيپىيەت=كەيپىيات
تۇرۇۋاسا=تۇرۇۋالسا
خىلالىغىدەك=قىلالىغۇدەك
بوساق=بولساق
قۇربۇمىز=قۇربىمىز
گەپلەگە=گەپلەرگە
بوسۇنكى=بولسۇنكى
گەپلەنى=گەپلەرنى
چېڭىڭدا=چېغىڭدا
سۇغۇققان=سوغۇققان
ئەسلەڭنى=ئەسلىڭنى
ئۆزگىرىشەنى=ئۆزگىرىشنى
بوغىلى=بولغىلى
گەپداللىق=گەپدانلىق
ۋەدىلەنى=ۋەدىلەرنى
بېرىۋەسە=بېرىۋەرسە
تەسىرلەنى=تەسىرلەرنى
ۋېدە=ۋەدە
بامىسا=بارمىسا
بىلەممەيسەن=بىلەلمەيسەن
ئاقىۋەتلەگە=ئاقىۋەتلەرگە
يەدىن=يەردىن
قوقۇپ=قورقۇپ
ئادەملەگە=ئادەملەرگە
نەشچە=نەچچە
ئىتلاغا=ئىتلارغا
ئىتلادىنمۇ=ئىتلاردىنمۇ
كۆسەڭ=كۆرسەڭ
نۇختىنى=نۇقتىنى
قامما=قالما
كەممەپتۇ=كەلمەپتۇ
كارتۇشكىشىنى=كارتۇشكىسىنى
بويۇلۇپ=بويىلىپ
ۋاپاتار=ۋاپادار
كارتوشكىسىنىڭ=كارتۇشكىسىنىڭ
ھېكايىلە=ھېكايىلەر
ناھايىتىمى=ماھىيىتىمۇ
تۈپەيلىدىم=تۈپەيلىدىن
تاساداپېيلىقلا=تاسادىپىيلىقلار
بوممىغان=بولمىغان
قاغىنىدەكلا=قالغىنىدەكلا
كۈنلەنىڭ=كۈنلەرنىڭ
قەتەرلىگىن=قەدىرلىگىن
يەدە=يەردە
مۇھابىتىمىز=مۇھەببىتىمىز
خەيىرنىسا=خەيرىنىسا
ناھويىلىك=ناھىيەلىك
قىمما=قىلما
يەۋېيتىمەن=يەۋېتىمەن
كۆكۈيۈنىنى=كۆكۈيۈننى
سىلكىنىگىنىكەن=سىلكىنگەنىكەن
كۆكۇن=كۆكۈيۈن
يانچىپ=يانجىپ
تۇشمۇتۈشتىن=تۇشمۇتۇشتىن
تىكەنلەنى=تىكەنلەرنى
يەگە=يەرگە
سانچىيدۇ=سانجىيدۇ
تىمساققا=تىمساھقا
كەمچىلىكلەنى=كەمچىلىكلەرنى
ئەمەسىرىمەيمەن=ئەنسىرىمەيمەن
ئىشلاغىلا=ئىشلارغىلا
پالەش=پالەچ
كۆسەتكىلە=كۆرسەتكىلى
ئورىۋاغان=ئورىۋالغان
بوغاچقا=بوغقاچقا
مېھىر-مۇھاببىتىنى=مېھىر-مۇھەببىتىنى
كىرەممەي=كىرەلمەي
ئاپىرىم=ئاپىرىن
مېھرىمۇھەببەت=مېھىر-مۇھەببەت
ھەمخورلۇقىنى=غەمخورلۇقىنى
سېستىپ=سېسىتىپ
پەيتلەدىمۇ=پەيتلەردىمۇ
بەھارامان=بەخىرامان
چوۋۇپ=چۇۋۇپ
دەپتېرىگە=دەپتىرىگە
ئاسەن=ئاسان
تۇتامماي=تۇتالماي
ئويلاۋاتامسىلە=ئويلاۋاتامسىلەر
ئۆزگۇنىمۇ=ئۆزگىنىمۇ
مەنىلەدىن=مەنىلەردىن
مەزگىللەگىچە=مەزگىللەرگىچە
بوممىقىڭ=بولمىقىڭ
ئەزەلدىڭ=ئەزەلدىن
يۈزەدەيۈز=يۈزدەيۈز
بوغاندا=بولغاندا
چۈمۈلۈۋاتىمەن=چۆمۈلۈۋاتىمەن
كۆرسۇتۇۋاتىدۇ=كۆرسىتىۋاتىدۇ
خەلىتە=غەلىتە
ئارتۇقچىلىقلانىڭ=ئارتۇقچىلىقلارنىڭ
پازىتسىيە=پوزىتسىيە
پەدازلاپ=پەردازلاپ
لەننەت=لەنەت
لىفىت=لىفت
ئالتىنجى=ئالتىنچى
بازاغا=بازارغا
ھېتىم=پېتىم
باغاندا=بارغاندا
بايلىقلانىڭ=بايلىقلارنىڭ
قەيەدىن=قەيەردىن
كەگىنىنى=كەلگىنىنى
خىياللادىن=خىياللاردىن
تۇڭلاپ=توڭلاپ
باساممايدۇ=باسالمايدۇ
سۇغۇرتى=سۇغۇرتا
بوسىلا=بولسىلا
پۈتكىل=پۈتكۈل
بەسە=بەرسە
كۆرەممەيدىغان=كۆرەلمەيدىغان
ئەۋزەللىكە=ئەۋزەللىككە
خادىملادىن=خادىملاردىن
خادىملانىڭ=خادىملارنىڭ
ئىندىيان=ئىندىئان
بازادىكى=بازاردىكى
ماتېرى=ماتورى
ئىندىيانغا=ئىندىئانغا
بىكادىن=بىكاردىن
ئىقتىداراغا=ئىقتىدارغا
ئىگى=ئىگە
بەھرىلىنەلمايمىز=بەھرىلىنەلمەيمىز
كۈچلەنىڭ=كۈچلەرنىڭ
ساپمۇساق=ساپمىساق
كۈيلەنى=كۈيلەرنى
سەككىزىنجى=سەككىزىنچى
قەسەملە=قەسەملەر
ئۆزگىرىشلەنى=ئۆزگىرىشلەرنى
قەسەميات=قەسەمياد
مائارىپچىلانىڭ=مائارىپچىلارنىڭ
كىشىلەنىڭ=كىشىلەرنىڭ
دومالاپ=دومىلاپ
گېزىتلەمۇ=گېزىتلەرمۇ
كۆپىنچى=كۆپىنچە
مۇۋەپپىقيەتلەرنى=مۇۋەپپەقىيەتلەرنى
ساختىپەس=ساختىپەز
بۇتساتۋانىڭ=بۇدساتۋانىڭ
ھەيكىلا=ھەيكىلى
بۇتساتۋاغا=بۇدساتۋاغا
بولاممايمىز=بولالمايمىز
ئۆزۈنى=ئۆزىنى
ئېلېكتران=ئېلېكترون
لۇغەتلەنى=لۇغەتلەرنى
قامماي=قالماي
ئەسەرلە=ئەسەرلەر
قىمماقچى=قىلماقچى
بەگىلى=بەرگىلى
كەگەنلەرنىڭ=كەلگەنلەرنىڭ
ئىمدىھان=ئىمتىھان
بەگۈچىلا=بەرگۈچىلا
شىرىكەتمۇ=شىركەتمۇ
مەسىلىلەنى=مەسىلىلەرنى
بەسەڭ=بەرسەڭ
پازىسىيە=پوزىتسىيە
مۇۋەپپىقيەتكە=مۇۋەپپەقىيەتكە
جۈپئەت=جۈرئەت
ۋۇجۇدۇن=ۋۇجۇدۇڭ
بوممىغاندا=بولمىغاندا
كۈچتۈڭۈر=كۈچتۈڭگۈر
نىسىپەتەن=نىسبەتەن
ئۆستۈڭگە=ئۆستەڭگە
پالدىدىن=پالتىدىن
چاقاپتۇ=چايقاپتۇ
بېرىۋەتىپتۇ=بېرىۋېتىپتۇ
ئاشكۆز=ئاچكۆز
خەزەپلەنگەن=غەزەپلەنگەن
تەڭلى=تەڭلا
پەلسەپەۋىي=پەلسەپىۋى
قىمماسلىققا=قىلماسلىققا
قىلمىيىش=قىلمىش
دەسمايگە=دەسمايىگە
تەكتىكا=تاكتىكا
ھازىرقىچە=ھازىرغىچە
ئادەملەدۇر=ئادەملەردۇر
مۇۋاپپەقىيەتكە=مۇۋەپپەقىيەتكە
ئېرىشەممەيدۇ=ئېرىشەلمەيدۇ
بومماي=بولماي
تەرجىمالىنى=تەرجىمىھالىنى
خەتە=خەتتە
گېراماتىكىلىق=گرامماتىكىلىق
خاتالىقلانىڭ=خاتالىقلارنىڭ
ئاممايدۇ=ئالمايدۇ
چالايدىغان=چاغلايدىغان
ئۇچۇرىتىپ=ئۇچرىتىپ
سەۋەبلە=سەۋەبلەر
پىسىخىكىسىنىڭ=پسىخىكىسىنىڭ
بىلىملەنى=بىلىملەرنى
خالتىس=قالتىس
مۇۋاپپىقىيەتنىڭ=مۇۋەپپەقىيەتنىڭ
ئىلىكتۇرۇن=ئېلېكترون
ھەىركەتكە=ھەرىكەتكە
گېيگانت=گىگانت
گېگانت=گىگانت
ئېسىلۋالمىغان=ئېسىلىۋالمىغان
قامماستىن=قالماستىن
مۇۋەپپىقيەتتىن=مۇۋەپپەقىيەتتىن
پازىتسىيەسىگە=پوزىتسىيەسىگە
بوممايمىز=بولمايمىز
پازىتسىيىنى=پوزىتسىيەنى
توسالغۇلادىنمۇ=توسالغۇلاردىنمۇ
سەۋىرچان=سەۋرچان
كېتەمىكىن=كېتەرمىكىن
قوقتۇم=قورقتۇم
خەرخىل=ھەرخىل
يېڭىلىقلانى=يېڭىلىقلارنى
ئالاھىدرەك=ئالاھىدىرەك
قۇللادۇر=قۇللاردۇر
خالامايدىغان=خالىمايدىغان
قىلاممايدۇ=قىلالمايدۇ
تاۋۇ=تاۋى
قورقۇدۇ=قورقىدۇ
قوقۇدۇ=قورقىدۇ
قىمماسلىقتۇر=قىلماسلىقتۇر
قاڭغۇراق=قوڭغۇراق
قورامىڭغا=قۇرامىڭغا
باتۇرانى=باتۇرانە
ئەزىمىلىك=ئەزمىلىك
ئاقىلانى=ئاقىلانە
شان-شەرپىڭ=شان-شەرىپىڭ
ئازىراقلا=ئازراقلا
دېيىلگىنىكەن=دېيىلگەنىكەن
ئالدامچىلانىڭ=ئالدامچىلارنىڭ
كىشىلەدىكى=كىشىلەردىكى
قەدەمىي=قەدىمىي
ساتامماي=ساتالماي
چىقىراممىغان=چىقىرالمىغان
ئايرىيالامسەن=ئايرىيالمامسەن
ئالماشتۇرامماسمۇ=ئالماشتۇرالماسمۇ
ئېھتىمانلىقى=ئېھتىماللىقى
مىلياردىن=مىلياردتىن
شۇئەر=شوئار
سوقۇپۇ=سوقۇپتۇ
قىمماي=قىلماي
قىلىۋەگۈدەك=قىلىۋەرگۈدەك
ماجارى=ماجالى
قاممۇپتۇ=قالماپتۇ
ئاممايمەن=ئالمايمەن
دەپۇ=دەپتۇ
تۇيغىسىنى=تۇيغۇسىنى
تۇتۇۋالامماسلىق=تۇتۇۋالالماسلىق
رەقىپلىرىنى=رەقىبلىرىنى
تۈزگەش=تۈزگەچ
قىلامماسلىق=قىلالماسلىق
تالاشىش=تالىشىش
پۇرسەتلەگە=پۇرسەتلەرگە
توققۇزىنجى=توققۇزىنچى
ئىشچىلانىڭ=ئىشچىلارنىڭ
بېرىدىغانلىقڭىزنى=بېرىدىغانلىقىڭىزنى
دۆۋۈلىۋېتىلگەن=دۆۋىلىۋېتىلگەن
كۆچكۈنىمىز=كۆچكىنىمىز
بامۇ=بارمۇ
ئۈنجىقلاپ=ئىنجىقلاپ
ئىشچىلاغا=ئىشچىلارغا
بوسام=بولسام
تاتماس=تارتماس
تارتماسكەنمە=تارتماسكەنمەن
توغرۇلۇقلا=توغرىلىقلا
نۇرغىن=نۇرغۇن
باشقىلارنۇ=باشقىلارمۇ
باشقتا=باشتا
قىرىقىنجى=قىرىقىنچى
مۇئەللىقتا=مۇئەللەقتە
يامىشپ=يامىشىپ
كېتەرىشى=كېتەلىشى
بوسىمۇ=بولسىمۇ
ئىمكانىيەتلەنىڭ=ئىمكانىيەتلەرنىڭ
كېلەممەسلىك=كېلەلمەسلىك
ئاقىۋەتلەنى=ئاقىۋەتلەرنى
ئاراسالدا=ئارىسالدى
يۈگۈدەك=يېگۈدەك
ئادەملە=ئادەملەر
ئالدىڭگا=ئالدىڭغا
يامۇشاممايسەن=يامىشالمايسەن
توچتىمۇ=توشتىمۇ
خىلتا=خالتا
قىلماتۇ=قىلماپتۇ
خالتۇ=خالتا
ئىددىيىۋى=ئىدىيەۋى
تۆۋەندىكىلەك=تۆۋەندىكىدەك
تاپاماسلىقىڭ=تاپماسلىقىڭ
بەمىسەڭ=بەرمىسەڭ
باغقال=باققال
خېرىدارگە=خېرىدارغا
كۈنلۈمسىرەپ=كۈلۈمسىرەپ
قوسىقىمىز=قورسىقىمىز
كىشىلەنىڭلا=كىشىلەرنىڭلا
ئىددىيىسى=ئىدىيەسى
ھوزۇرلىناي=ھۇزۇرلىناي
خىسلەتلەنى=خىسلەتلەرنى
يېتىلدۇرىشىڭ=يېتىلدۈرۈشۈڭ
بوممىسىمۇ=بولمىسىمۇ
پىكىرلەنىڭ=پىكىرلەرنىڭ
پىكرىمگە=پىكىرىمگە
پىكىنىڭگە=پىكىرىڭگە
تەرەپتارى=تەرەپدارى
داۋاگەرلەرنىڭ=دەۋاگەرلەرنىڭ
تەنقىتسىز=تەنقىدسىز
ۋاقىراشلار=ۋارقىراشلار
ئەيپلىشىپ=ئەيىبلىشىپ
ئىنقىلاپچىلارنى=ئىنقىلابچىلارنى
ئىددىيەسىگە=ئىدىيەسىگە
ئەيىپلەنمەيدۇ=ئەيىبلەنمەيدۇ
ئادەتتىكچى=ئادەتتىكىچە
چىماپ=چىرماپ
سەۋەبلەنىڭ=سەۋەبلەرنىڭ
دۈلتلۈكىنى=دۆتلۈكىنى
بوغانسېرى=بولغانسېرى
پازىتسىيىسىنى=پوزىتسىيەسىنى
ئىددىيىنىڭ=ئىدىيەنىڭ
تەۋرىنۈپ=تەۋرىنىپ
چاپلىشىۋاغانلىقىنى=چاپلىشىۋالغانلىقىنى
بوغاچقىلا=بولغاچقىلا
كۈنلەنى=كۈنلەرنى
ئوبداراق=ئوبدانراق
خىرىتىغا=خىرىسىغا
پازىتسىيىڭنى=پوزىتسىيەڭنى
بەگەنلىكى=بەرگەنلىكى
تەرىپە=تەرىپى
خاتالىقنا=خاتالىقنى
ئىنكاستىكىلە=ئىنكاستىكىلەر
بەزىلەنىڭ=بەزىلەرنىڭ
ئامماي=ئالماي
بىلۇپ=بىلىپ
ئەرسىمەيدۇ=ئەرزىمەيدۇ
ئوبرازنە=ئوبرازنى
بوساڭلا=بولساڭلا
بۇغۇنىڭ=بۇغىنىڭ
كۆسىتىپتۇ=كۆرسىتىپتۇ
يېيەممەپتۇ=يېيەلمەپتۇ
ئىدىيدىن=ئىدىيەدىن
بەمەيدۇ=بەرمەيدۇ
ھايۋامات=ھايۋانات
كاللىكتىپ=كوللېكتىپ
ھېقابەتنى=رىقابەتنى
ئاممىغاندا=ئالمىغاندا
ئاساق=ئالساق
مەزھەپلە=مەزھەپلەر
خۇلاس=خۇلاسە
مەللا=مەنلا
غوزۇرلىنىپ=ھۇزۇرلىنىپ
يېڭەممەيدۇ=يېڭەلمەيدۇ
بوسىغۇ=بولسىغۇ
دەسمايىڭنى=دەسمايەڭنى
بوغانلىرىڭغا=بولغانلىرىڭغا
بوماي=بولماي
تەرەپلىمۇ=تەرەپلىمە
تۇراممايدۇ=تۇرالمايدۇ
ھوزۇرلانسۇن=ھۇزۇرلانسۇن
ئاسانلۇ=ئاسانلا
ئەتراپىدىكىلە=ئەتراپىدىكىلەر
تاللىۋاسام=تاللىۋالسام
ئېلىۋەگەن=ئېلىۋەرگەن
نەتىجىيە=نەتىجىدە
كىشىلەنىڭكىدىنمۇ=كىشىلەرنىڭكىدىنمۇ
ئاممىساڭ=ئالمىساڭ
ئاچكۆزلۈكىڭگە=ئاچكۆزلۈكۈڭگە
قىمماسلىقى=قىلماسلىقى
بوغۇدەك=بولغۇدەك
ئاچكۆزلەچە=ئاچكۆزلەرچە
تەسىرەت=تەسىرات
ئوبرازىنغا=ئوبرازىڭغا
ئەپسۇسلۇلنارلىقى=ئەپسۇسلىنارلىقى
يامگراپ=يامراپ
كىشىلەدىن=كىشىلەردىن
قامماسلىقىڭنى=قالماسلىقىڭنى
بولۇشىڭنى=بولۇشۇڭنى
ئېرىشەرەيسەن=ئېرىشەلەيسەن
جۇڭگوۇ=جۇڭگو
بوممىغاچقا=بولمىغاچقا
ئامىللەرمۇ=ئامىللارمۇ
ھايۋەن=ھايۋان
ئېكولوگىيىلىك=ئېكولوگىيەلىك
نىسبى=نىسپىي
ئاتلەتكا=ئاتلېتىكا
ئاغۇچى=ئالغۇچى
ئاتلىتىكە=ئاتلېتىكا
ناتەيىن=ناتايىن
شالىنىپ=شاللىنىپ
چۈشۈنۈلۈپ=چۈشىنىلىپ
ھالاردا=ھاللاردا
تەرەپلەدە=تەرەپلەردە
بۈركۈتلەنىڭ=بۈركۈتلەرنىڭ
بۈركۈتلەنى=بۈركۈتلەرنى
ئالامماي=ئالالماي
بىركۈت=بۈركۈت
پەيلەنى=پەيلەرنى
پەيلەمۇ=پەيلەرمۇ
پاتىڭدىن=پاتىڭىدىن
تۇزۇقى=تۇزىقى
قالغىچىلىكى=قالغۇچىلىقى
ئۈلگۈرەممەيدىغان=ئۈلگۈرەلمەيدىغان
ئوۋچىلىنىڭ=ئوۋچىلارنىڭ
توزۇقلانىڭ=تۇزاقلارنىڭ
توزاقلانى=تۇزاقلارنى
توزاقنى=تۇزاقنى
كەيدۈرۈش=كىيدۈرۈش
ئوۋچىلانىڭ=ئوۋچىلارنىڭ
توزۇقىغا=تۇزىقىغا
شاخ-شۇمبۇلا=شاخ-شۇمبىلار
سېزەممەيدۇ=سېزەلمەيدۇ
ئۇنىگ=ئۇنىڭ
تۇرۇۋەمەيدۇ=تۇرۇۋەرمەيدۇ
جەھەتلەدە=جەھەتلەردە
تۈزىتەممىسەڭ=تۈزىتەلمىسەڭ
قالاممىساڭ=قالالمىساڭ
شالىدۇ=سالىدۇ
بوغاندىن=بولغاندىن
ئەچىقىپ=ئاچىقىپ
بېرەممەي=بېرەلمەي
چۈشۈرۇۋەتىدىكەن=چۈشۈرۈۋېتىدىكەن
چۆچىلىرىگە=چۈجىلىرىگە
باراممايدۇ=بارالمايدۇ
شەيئىلەگە=شەيئىلەرگە
تىكەنلەگە=تىكەنلەرگە
مۇۋاپەقىيەت=مۇۋەپپەقىيەت
مۇۋاپەقىيەتلەرگە=مۇۋەپپەقىيەتلەرگە
تامامەم=تامامەن
بولۇشاڭ=بولۇشۇڭ
پېتىناممىغان=پېتىنالمىغان
ئۆگۈتۈپ=ئۆگىتىپ
بوغىنىكەن=بولغىنىكەن
كەممەيدۇ=كەلمەيدۇ
دەريالادىنمۇ=دەريالاردىنمۇ
قىلاممىساڭ=قىلالمىساڭ
دېڭىزلادىن=دېڭىزلاردىن
قىممىساڭمۇ=قىلمىساڭمۇ
بوممىقى=بولمىقى
لاسىم=لازىم
چوڭقىرمىدۇ=چوڭقۇرمىدۇ
بومايدۇ=بولمايدۇ
خىزمەتلەنى=خىزمەتلەرنى
كۆسىتىش=كۆرسىتىش
قىلاممايدىغان=قىلالمايدىغان
بولامايمىز=بولالمايمىز
باغانسېرى=بارغانسېرى
مۇۋاپەقىيەتمۇ=مۇۋەپپەقىيەتمۇ
ئېزىقتۇرۇشلا=ئېزىقتۇرۇشلار
لەنىنزىمنىڭ=لېنىنىزمنىڭ
كوممۇنىزىمى=كوممۇنىزمىمۇ
ئىستىراتىگىيەسى=ئىستراتېگىيەسى
ئېدىئولوگىيەنىڭ=ئىدېئولوگىيەنىڭ
تەدبىقلىدى=تەتبىقلىدى
كونتۇرۇللىقىدا=كونتروللۇقىدا
بولۇك=بولۇڭ
باشلىد=باشلىدى
پىسخولوگىيەلىك=پسىخولوگىيەلىك
قۇرالدۇر=قورالدۇر
ئۈمۈدنىڭ=ئۈمىدنىڭ
ئىستارتىگىيەسى=ئىستراتېگىيەسى
رەدىيە=رەددىيە
باھانىدا=باھانىدە
گۈللەدىن=گۈللەردىن
ھوزۇرلىنىپتۇ=ھۇزۇرلىنىپتۇ
قۇرت-توڭغۇزلار=قۇرت-قوڭغۇزلار
چەمدەر=چەمبەر
ھوزىرلىنالماي=ھۇزۇرلىنالماي
پاراڭلىشامماپتۇ=پاراڭلىشالماپتۇ
چۈشىنەمەيدىغان=چۈشىنەلمەيدىغان
ئاشۇراممايدىغان=ئاشۇرالمايدىغان
قاممايسەن=قالمايسەن
مۇسادىقىسىدۇر=مۇسابىقىسىدۇر
كاماندىنىڭمۇ=كوماندىنىڭمۇ
راياللىق=رېئاللىق
بۇرۇقتۇرمۇ=بۇرۇقتۇرما
مۇھەببەتلەنى=مۇھەببەتلەرنى
تۇرغىنىكەن=تۇرغانىكەن
يىتتۇردىڭىزمۇ=يىتتۈردىڭىزمۇ
يۆتتۈرۈپ=يىتتۈرۈپ
ئىسدەيدۇ=ئىزدەيدۇ
كۆسە=كۆرسە
تاپاممايدۇ=تاپالمايدۇ
يەرلەنى=يەرلەرنى
بىكاغا=بىكارغا
كۆرۈۋاتقانلىغىنى=كۆرۈۋاتقانلىقىنى
ئىپادىدەپ=ئىپادىلەپ
قاماستىن=قالماستىن
قىممىسام=قىلمىسام
بوتۇلگا=بوتۇلكا
باھلىقىنى=بارلىقىنى
بىلەممەي=بىلەلمەي
شۈت=سۈت
بوتۇلكە=بوتۇلكا
قالامايمىز=قالالمايمىز
دىققىچىمىزنى=دىققىتىمىزنى
كەتمەڭلا=كەتمەڭلار
جەۋھەرى=جەۋھىرى
يوغۇرۇلغان=يۇغۇرۇلغان
ئۆلىمالانىڭ=ئۆلىمالارنىڭ
قايغۇ-ھەسىرەت=قايغۇ-ھەسرەت
خاتالىقلادىن=خاتالىقلاردىن
يۈرىمە=يۈرمە
يەپيېڭى=يېپيېڭى
قىبلىنامە=قىبلىنەما
ئەنگۈشتىرىنى=ئەڭگۈشتىرىنى
قاغانىكەن=قالغانىكەن
ئوت-چۆپلە=ئوت-چۆپلەر
قاغىنىغا=قالغىنىغا
بوۇپ=بولۇپ
بوساممۇ=بولساممۇ
ئۆتۈمىز=ئۆتمىز
ئاھرىنىدۇ=ئاغرىنىدۇ
نەرسىلەدىن=نەرسىلەردىن
ئايىقىنىڭ=ئايىغىنىڭ
نەرسىلەنىڭ=نەرسىلەرنىڭ
بىرىنجىسى=بىرىنچىسى
نىشاڭغا=نىشانغا
ھوزۇرلىنالايدىغان=ھۇزۇرلىنالايدىغان
قازىناممىغانلىقى=قازىنالمىغانلىقى
بوغانلىرىڭنى=بولغانلىرىڭنى
ئىلكىڭدە=ئىلىكىڭدە
قىمماسلىقمۇ=قىلماسلىقمۇ
غەم-غۇسسا=غەم-غۇسسە
پاتقىغغا=پاتقىقىغا
پاتۇرۋالما=پاتۇرۇۋالما
پاتۇرامماي=پاتۇرالماي
قائىدىلەنى=قائىدىلەرنى
قائىدىلەگە=قائىدىلەرگە
قىممىدى=قىلمىدى
تېگى-تەخدىدىن=تېگى-تەكتىدىن
بوممىغىنىكەن=بولمىغانىكەن
چايكىلاڭنى=چايكىلارنى
پىداگوبىكا=پېداگوگىكا
تېخھىمۇ=تېخىمۇ
سىلەنى=سىلەرنى
ئاغرىنغدەك=ئاغرىنغۇدەك
ھېچقاناق=ھېچقانداق
تاپشۇرۇۋاغاندىن=تاپشۇرۇۋالغاندىن
ئوڭايسىلانغان=ئوڭايسىزلانغان
سېلىشتۇراممايدۇ=سېلىشتۇرالمايدۇ
بوغانمۇ=بولغانمۇ
يېتەممەيدۇ=يېتەلمەيدۇ
نەرسىلە=نەرسىلەر
پىسىخىكىسى=پسىخىكىسى
بومماسلىقى=بولماسلىقى
بولاممايسەن=بولالمايسەن
گۈللەنىڭ=گۈللەرنىڭ
چىقىملادىن=چىقىملاردىن
قەدىرى=قەدرى
قەلەندەرلەنىڭ=قەلەندەرلەرنىڭ
بولاممايۋاتىمەن=بولالمايۋاتىمەن
ھەجلەپ=خەجلەپ
كەممىسە=كەلمىسە
بولاممىغانلىقىڭدىن=بولالمىغانلىقىڭدىن
قازىناممىغان=قازىنالمىغان
تاپاممىغانلىقىمىزدىن=تاپالمىغانلىقىمىزدىن
قېتىنچىلىقلانى=قېتىنچىلىقلارنى
خۇشالخورام=خۇشال-خۇرام
كەممىگەن=كەلمىگەن
كۆگىلى=كۆرگىلى
ساياھەتچىلەنىڭ=ساياھەتچىلەرنىڭ
چوڭيىپ=چوڭىيىپ
يىلاڭ=يىلان
ئادەملەنى=ئادەملەرنى
قامماپتۇ=قالماپتۇ
ئىستاكام=ئىستاكان
لېمان=لىمون
لېمۇننى=لىموننى
مۇۋەپپىقىيەتلەنى=مۇۋەپپەقىيەتلەرنى
تۈتكە=تۈرتكە
كۆڭۈلسىزلىكلەنىڭ=كۆڭۈلسىزلىكلەرنىڭ
كۆسىتىدىكەن=كۆرسىتىدىكەن
بوممايدىكەن=بولمايدىكەن
قاخشاشلىرىدىن=قاقشاشلىرىدىن
كۆگۈلسىز=كۆڭۈلسىز
ئاغرىنىھ=ئاغرىنىش
بەگەنلىرى=بەرگەنلىرى
ھالاس=خالاس
قاممايدۇ=قالمايدۇ
ساقلانقىلى=ساقلانغىلى
چىقاماي=چىقارماي
نىسبىدى=نىسبىتى
باشقىلانىڭكىدىن=باشقىلارنىڭكىدىن
ئوڭۇشسىزلىقلانىڭ=ئوڭۇشسىزلىقلارنىڭ
دېيەممەيمىز=دېيەلمەيمىز
ئەخلەتلەنى=ئەخلەتلەرنى
توساۋالمىسۇن=توسۇۋالمىسۇن
بىيسىپلا=بېسىپلا
ئەۋەتىلەپتۇ=ئەۋەتىلىپتۇ
بوغۇسى=بولغۇسى
دۆلەتلە=دۆلەتكە
بۇنچىۋلا=بۇنچىۋالا
مىزگەنچى=مىزگانچى
قارىشىغ=قارىشىڭ
پەقەتلە=پەقەتلا
نىزگانچا=مىزگانچى
چاغا=چاغان
ھۇززۇرلىنىش=ھۇزۇرلىنىش
مىزگارچىغا=مىزگانچىغا
بەختىسزلىكنى=بەختسىزلىكنى
يوقىتىۋېتەممەيدۇ=يوقىتىۋېتەلمەيدۇ
قەلبىغە=قەلبىگە
ئۇرۇلىسا=ئۇرۇلسا
كىيمىم=كىيىمىم
دالىدىكى=دالادىكى
تارتىۋاغىلى=تارتىۋالغىلى
قەلپنىڭ=قەلبنىڭ
لايھىلىسەك=لايىھىلىسەك
تەددىر=تەقدىر
ماڭغىنىكەن=ماڭغانىكەن
ئۆلتۈرەمدىكىنا=ئۆلتۈرەمدىكىنە
مېنىۋالغىننى=مىنىۋالغىنىنى
كۆڭۈلدۈكىدەك=كۆڭۈلدىكىدەك
يۈز-ئابرويى=يۈز-ئابرۇيى
مەنپەئەدىنى=مەنپەئەتىنى
سۇبېكتىپ=سۇبيېكتىپ
باشقىلارنىگ=باشقىلارنىڭ
شەخسىيرتچىلىك=شەخسىيەتچىلىك
قۇرۇلدىلىپ=قۇرۇقدىلىپ
بەختىسىز=بەختسىز
يۈرەممەيدۇ=يۈرەلمەيدۇ
كۆمەيدۇ=كۆرمەيدۇ
ئۇنچۇۋالا=ئۇنچىۋالا
ئىدىيەۋىي=ئىدىيەۋى
ئەكېلەلمەپتۇ=ئەكىلەلمەپتۇ
ئىبارىلە=ئىبارىلەر
بەگىنىمنى=بەرگىنىمنى
بەگىنىمدە=بەرگىنىمدە
بومماپتۇ=بولماپتۇ
قىزانغان=قازانغان
كىشىلەنى=كىشىلەرنى
تەرەپپۇزىدا=تەلەپپۇزىدا
ئادەتلەنگىنىكەن=ئادەتلەنگەنىكەن
قىممايدۇ=قىلمايدۇ
ئاستىدىكىلەگە=ئاستىدىكىلەرگە
ساۋاقلانى=ساۋاقلارنى
يەكىنلەشكە=يەكۈنلەشكە
ھازىل=ھاسىل
بۇيرۇقماسلىق=بۇيرۇقۋازلىق
پىكرىنى=پىكىرىنى
تۇنجۇ=تۇنجى
بەگىنىدىم=بەرگەنىدىم
بەدى=بەردى
بىجانىدىل=بەجانىدىل
پەزىلەتلەنى=پەزىلەتلەرنى
مېيلى=مەيلى
پىسىخىك=پسىخىك
چوڭلالا=چوڭلارلا
جەھەتتې=جەھەتتە
پىسېخىكىسى=پسىخىكىسى
يۇقىلىپ=يوقىلىپ
ئوتىنچى=ئوتۇنچى
بوۇپتۇ=بولۇپتۇ
پالتىڭ=پالتاڭ
ئارىپ=ئاغرىپ
ئۇنتۇياممايمەن=ئۇنتۇيالمايمەن
زەخملەندۈرىدۇ=زەخىملەندۈرىدۇ
ئېغزى=ئېغىزى
ئىتتىكلىق=ئىتتىكلىك
ئازەر=ئازار
ئۆگىنىۋاساقلا=ئۆگىنىۋالساقلا
دەتالاشلانى=دەتالاشلارنى
ئۆنۈملۈك=ئۈنۈملۈك
ئاغزىڭنى=ئېغىزىڭنى
جارائەتتىن=جاراھەتتىن
جىرائىتىنى=جاراھىتىنى
مىسارى=مىسالى
بوممىسۇن=بولمىسۇن
پەقەتتە=پەقەتلا
باسامماپتۇ=باسالماپتۇ
خاراپلىشىپتۇ=خارابلىشىپتۇ
ئىستېدەت=ئىستېدات
كانكرىت=كونكرېت
خىزمەتلەگىلا=خىزمەتلەرگىلا
خادىن=خادىم
بىربىرىدە=بىر-بىرىدە
خىزمەتتاش=خىزمەتداش
كېلىشەممەي=كېلىشەلمەي
باردى-كەلدە=باردى-كەلدى
قىلىشسىڭلا=قىلىشساڭلا
پىرەنسىپقىمۇ=پرىنسىپقىمۇ
بوپ=بولۇپ
ياشىياممايدۇ=ياشىيالمايدۇ
چۆمۈس=چۆمۈچ
ئەينىن=ئەينەن
سالغىنىكەن=سالغانىكەن
سۈكۈتتۈ=سۈكۈتتە
بەگىن=بەرگىن
قوشۇلامۇ=قوشۇلارمۇ
قايتۇرمۇ=قايتۇرما
كۆرەمىز=كۆرەرمىز
ئىغۋاگەتچىلىك=ئىغۋاگەرچىلىك
ۋااي=ۋاي
يارىتاممايدۇ=يارىتالمايدۇ
ئادىتىن=ئادىتىنى
يېتىلدۈرۋال=يېتىلدۈرۈۋال
كۆزكۆز=كۆز-كۆز
سىياسىيۇنى=سىياسىيونى
قىغىنىكەن=قىلغىنىكەن
چۈشەڭەن=چۈشەنگەن
ئانالاس=ئانالىز
سەبىيلەچە=سەبىيلەرچە
كۈدە-كۆپەڭنى=كۈدە-كۆرپەڭنى
ئاڭلىياممايدۇ=ئاڭلىيالمايدۇ
ئاڭقىراممىغان=ئاڭقىرالمىغان
سالىدۇدە=سالىدۇ-دە
ئۆگىنىۋاساڭ=ئۆگىنىۋالساڭ
چىمپىيونە=چېمپىيون
شىمپەنسە=شىمپەنزە
باغان=بارغان
شىمبەنزىلا=شىمپەنزىلا
چاۋاپ=چاۋاك
غورۇرىڭنى=غۇرۇرۇڭنى
كۆرەممەسلىك=كۆرەلمەسلىك
پىسىخىكىسىنى=پسىخىكىسىنى
كىيىۋىغانلىقىنى=كىيىۋالغانلىقىنى
رەخنى=رەختنى
ئوخشاشلانىڭ=ئوخشاشلارنىڭ
تېگى-تەھدىدىن=تېگى-تەكتىدىن
كۆرسىتەممەيدۇ=كۆرسىتەلمەيدۇ
كۆمىسە=كۆرمىسە
ھەنجەر=خەنجەر
كۆسىتەلىشى=كۆرسىتەلىشى
باسۇن=بارسۇن
تاتقان=تارتقان
ئاۋارىچىلىقىڭنىڭ=ئاۋارىچىلىكىڭنىڭ
ئۆزگەرتەممىسەڭ=ئۆزگەرتەلمىسەڭ
ئاغزىدىن=ئېغىزىدىن
لاۋىلدىدى=لاۋۇلدىدى
جوڭگۇدا=جۇڭگودا
ئاغزىدا=ئېغىزىدا
ئاغىزلىرى=ئېغىزلىرى
قارغىلارغا=قاغىلارغا
ئاغزىنى=ئېغىزىنى
رەخمېت=رەھمەت
سىزگې=سىزگە
ھۇجۇدى=ۋۇجۇدى
نېرىنكىرلىق=نىرىنكىرلىق
چاشلىرىنى=چاچلىرىنى
چاممايدىغان=چالمايدىغان
سىزلېرگە=سىزلەرگە
پىكرىدە=پىكىرىدە
تۈڭنۈكىدىن=تۈڭلۈكىدىن
ساقايمىغىدەك=ساقايمىغۇدەك
قاسىلا=قالسىلا
چۆمۈلىگە=چۈمۈلىگە
تىيىنگە=تىيىنغا
پىكرىڭ=پىكىرىڭ
دەخلى-تەرىزە=دەخلى-تەرۇز
كۆسىتىشكە=كۆرسىتىشكە
قارىشىمنا=قارىشىملا
قىمماسلىق=قىلماسلىق
پىكرىڭنى=پىكىرىڭنى
بومما=بولما
ماھەررىر=مۇھەررىر
ئېغىزنۇ=ئېغىزمۇ
خىزمەتچىلەگىچە=خىزمەتچىلەرگىچە
شانشەرەپكە=شان-شەرەپكە
ئېرشىپ=ئېرىشىپ
مەنسۇق=مەنسۇپ
بەگەنلىكىگە=بەرگەنلىكىگە
شانشەرەپتىن=شان-شەرەپتىن
ئۈستۈۋالىسەن=ئۈسۈۋالىسەن
شانشەرىپىڭ=شان-شەرىپىڭ
تەكلىۋىمگە=تەكلىپىمگە
قىممىساڭ=قىلمىساڭ
سانجىلىۋەگەچكە=سانجىلىۋەرگەچكە
كىرپىلە=كىرپىلەر
مۇۋاپپىق=مۇۋاپىق
كىرپىلەنىڭ=كىرپىلەرنىڭ
دوستەك=دوستتەك
نىتايىن=ناتايىن
دوسلا=دوستلار
يۈرىۋەگەچكە=يۈرۈۋەرگەچكە
تەربىيدە=تەربىيەدە
قارشىلىقلامۇ=قارشىلىقلارمۇ
غوتۇنداشقا=غوتۇلداشقا
بولپ=بولۇپ
قىڭغىر-سىڭگىر=قىڭغىر-سىڭغىر
كېتىدۇدە=كېتىدۇ-دە
يۈرمەسلى=يۈرمەسلىك
مۇنداقچې=مۇنداقچە
سۈركۈلۈپ=سۈركىلىپ
نيويورك=نيۇ-يورك
ئاتىپ=ئارتىپ
ئۈستا=ئۇستا
باغاندىن=بارغاندىن
قاغۇدەك=قالغۇدەك
خىزمەتچىلەنى=خىزمەتچىلەرنى
ئاغزى-ئاغزىغا=ئېغىزى-ئېغزىغا
ماقتاشلار=ماختاشلار
ئەربوپلار=ئەربابلار
ئاغزى=ئېغىزى
كېتىدىغانلانى=كېتىدىغانلارنى
ئاڭلايدىغانلانى=ئاڭلايدىغانلارنى
كۆسۇن=كۆرسۇن
بېرەممەپتىمەن=بېرەلمەپتىمەن
بەسەم=بەرسەم
تەسىراتلانىڭ=تەسىراتلارنىڭ
دېيەممەيمەن=دېيەلمەيمەن
قىسقىغىنا=قىسقىغىنە
چۆچەكلەنى=چۆچەكلەرنى
چۈشلەگە=چۈشلەرگە
بوممىسىكەن=بولمىسىكەن
بالىلاچە=بالىلارچە
يەلىرىممۇ=يەرلىرىممۇ
بوممايدىغانلىقى=بولمايدىغانلىقى
چۆچەكلە=چۆچەكلەر
مويسىپىتلانىڭ=مويسىپىتلارنىڭ
ئۆتۈدىكەن=ئۆتىدىكەن
كۆرۈدىكەن=كۆرىدىكەن
ئوغىرلىدى=ئوغرىلىدى
ئوغىردەك=ئوغرىدەك
ھەمىيشە=ھەمىشە
ئوغىرلىغان=ئوغرىلىغان
يەتكۈزۈۋامما=يەتكۈزۈۋالما
كۆدۈڭ=كۆردۈڭ
كۆدۈم=كۆردۈم
مۈشكىلاتقا=مۈشكۈلاتقا
ھېكمەتلەگىلا=ھېكمەتلەرگىلا
گۈرۈش=گۈرۈچ
تەڭشىيەممىگەن=تەڭشىيەلمىگەن
سۈپەتلەدۇر=سۈپەتلەردۇر
قازىناماسلىقىڭ=قازىنالماسلىقىڭ
قوناقلانى=قوناقلارنى
ئاغاندىن=ئالغاندىن
چىقىرامماپتۇ=چىقىرالماپتۇ
قىممايمىز=قىلمايمىز
ئاشكۆزلۈك=ئاچكۆزلۈك
كۈمۈشلەگە=كۈمۈشلەرگە
قالاممايسەن=قالالمايسەن
چىقامماپتۇ=چىقالماپتۇ
داۋانلانى=داۋانلارنى
تاپامماپتۇ=تاپالماپتۇ
ئۇخلىياممايمەن=ئۇخلىيالمايمەن
قىلاممايمىز=قىلالمايمىز
بومماق=بولماق
كۈنلەدە=كۈنلەردە
قىممايدىغان=قىلمايدىغان
ھايۋانلانىڭمۇ=ھايۋانلارنىڭمۇ
بۆكەنلە=بۆكەنلەر
بولامماسلىقىڭ=بولالماسلىقىڭ
يۈكلەنى=يۈكلەرنى
بۆكەنلەنى=بۆكەنلەرنى
بۆكەنلەنىڭكىدىن=بۆكەنلەرنىڭكىدىن
بۆكەنلەنىڭ=بۆكەنلەرنىڭ
بۆرىلە=بۆرىلەر
زورۇيۇپ=زورىيىپ
بوغانلىقىدىن=بولغانلىقىدىن
كۆسىتىدىغان=كۆرسىتىدىغان
كۆرەممەيسەن=كۆرەلمەيسەن
قىممايمەن=قىلمايمەن
توسۇۋاسىلا=توسۇۋالسىلا
يوقسۇللاغا=يوقسۇللارغا
كۆسەتسە=كۆرسەتسە
ئادەملەنىڭلا=ئادەملەرنىڭلا
توسۇۋالاممايدۇ=توسۇۋالالمايدۇ
كىشىلەدەك=كىشىلەردەك
تاپشۇرۇۋاغان=تاپشۇرۇۋالغان
تۇرۇۋاغان=تۇرۇۋالغان
يورغۇلىتىدىغان=يورغىلىتىدىغان
مۇنازىر=مۇنازىرە
ئۈگىنىۋەلىشىڭ=ئۆگىنىۋېلىشىڭ
بولماسلىغىڭ=بولماسلىقىڭ
سامما=سالما
بومماسلىق=بولماسلىق
گەپلەنىمۇ=گەپلەرنىمۇ
ئۆگىنىۋاغان=ئۆگىنىۋالغان
ئەخمەقلەگە=ئەخمەقلەرگە
بوماسلىقىڭ=بولماسلىقىڭ
چىقاما=چىقارما
ئۆزگىلەگە=ئۆزگىلەرگە
مۇستەققەل=مۇستەقىل
كاللەكتىپ=كوللېكتىپ
مۇناسىۋەتلەنىڭ=مۇناسىۋەتلەرنىڭ
سوغات=سوۋغات
ئېلتىپاتلانى=ئىلتىپاتلارنى
تېپىۋالىسىلە=تېپىۋالىسىلەر
قىلاممىسا=قىلالمىسا
تاپاممىغاندىن=تاپالمىغاندىن
مەزمۇنلاغا=مەزمۇنلارغا
قاممىغان=قالمىغان
زورمۇزو=زورمۇزور
مۇناسىۋەتنە=مۇناسىۋەتنى
ئۆزگەگىمۇ=ئۆزگىگىمۇ
ۋاقىتىنچە=ۋاقتىنچە
ماقارە=ماقالە
دوئىلغا=دۇئېلغا
ئابروينى=ئابرۇينى
يەرىشا=يارىشا
تەنقىدلىمەتچى=تەنقىدلىمەكچى
بولمىغاننا=بولمىغاندا
تەڭقىدىڭ=تەنقىدىڭ
شۆھرەتپەرەستىكى=شۆھرەتپەرەسلىكى
ئاقىۋەتلەنىمۇ=ئاقىۋەتلەرنىمۇ
سەكسىنىنجى=سەكسەنىنچى
ئەنگلىيىلىك=ئەنگلىيەلىك
ئەنگىلىيىلىك=ئەنگلىيەلىك
يۈرگىنىكەن=يۈرگەنىكەن
ئەنگلىيىلىككە=ئەنگلىيەلىككە
ئاممىغان=ئالمىغان
كەسىپىگە=كەسپىگە
شاققا=شاخقا
ئېرىشەممەيلا=ئېرىشەلمەيلا
نىشەن=نىشان
چىرىمىۋالغان=چىرمىۋالغان
كىملەنىڭ=كىملەرنىڭ
دەئىم=دائىم
ياشىغىنىكەنسەن=ياشىغانىكەنسەن
ئېرىشەممەيسەن=ئېرىشەلمەيسەن
مۇناھ=موناخ
مۇرىدىڭ=مۇرىتىڭ
ئۆزۈڭمى=ئۆزۈڭمۇ
نېمەتلەنى=نېمەتلەرنى
پۇرسەنت=پۇرسەت
تىرىشچاڭ=تىرىشچان
چېچان=چېچەن
بېغەم=بىغەم
پۇرزەتنىمۇ=پۇرسەتنىمۇ
تاختىماي=توختىماي
رىقابەتلە=رىقابەتلەر
كەگەندىن=كەلگەندىن
مېكىينى=مېكىيىنى
باسۇرساق=باستۇرساق
چۈجى=چۈجە
چۆجىلەنى=چۈجىلەرنى
باسۇرماي=باستۇرماي
ئۇلارنىگ=ئۇلارنىڭ
ساساڭ=سالساڭ
قالايمىققان=قالايمىقان
تاپلاپ=توپلاپ
كېلپتۇ=كېلىپتۇ
بامىدى=بارمىدى
شۇنچىلىكلە=شۇنچىلىكلا
تۆلۈشۈڭ=تۆلىشىڭ
ئاغۇچىلاردىن=ئالغۇچىلاردىن
قۇرغۇلۇقىغا=قۇرۇقلۇقىغا
كېمىلەنىڭ=كېمىلەرنىڭ
كېمىلە=كېمىلەر
ئەنگىلىيىلىكلەنە=ئەنگلىيەلىكلەرنى
ھېكايى=ھېكايە
خىيالىدى=خىيالىدا
قازانالمايسەن=قازىنالمايسەن
دەسسەيدىدە=دەسسەيدۇ-دە
ئىشەنچمە=ئىشەنچمۇ
كىشىلەگە=كىشىلەرگە
دىلىغۇنلۇق=دېلىغۇللۇق
چىقاممايدۇ=چىقالمايدۇ
نىشاڭغىلا=نىشانغىلا
ئىدىيدىكى=ئىدىيەدىكى
دەككە-دۈككۈ=دەككە-دۈككە
پوزىتسىدە=پوزىتسىيەدە
قىيىنچىلىقلاغا=قىيىنچىلىقلارغا
قامماسلىق=قالماسلىق
بەدخەج=بەتخەج
پادىشاپا=پادىشاھ
كېچىگەچە=كېچىگىچە
چوڭقۇرلاق=چوڭقۇرراق
ئەقىللىقرا=ئەقىللىقراق
خاتىرجەمسىزلەندۈرۇپ=خاتىرجەمسىزلەندۈرۈپ
شان-شەرەپلەگە=شان-شەرەپلەرگە
ۋايىغە=ۋايىغا
كۆسەت=كۆرسەت
قىممىدىم=قىلمىدىم
ساھەلەدە=ساھەلەردە
پروففېسسور=پروفېسسور
ئورنۇنى=ئورنىنى
مۈشكۈلاتلا=مۈشكۈلاتلار
ئاممىغاچقا=ئالمىغاچقا
كۆرگەزمەخانىلىرىغا=كۆرگەزمىخانىلىرىغا
بازىر=بازىرى
پۇرسەتلەنى=پۇرسەتلەرنى
ناسارەتچىسى=نازارەتچىسى
ساتاممىساڭ=ساتالمىساڭ
كۆسەتسەڭ=كۆرسەتسەڭ
چىقانغا=چىققانغا
ئالاھىدىلىكلەنى=ئالاھىدىلىكلەرنى
بازارگا=بازارغا
گىربىكىگە=گىرۋىكىگە
ئومۇمۇ=ئومۇمى
قىمماپتۇ=قىلماپتۇ
ھەممىسە=ھەممىسى
ئېرىشەممىگەن=ئېرىشەلمىگەن
كېپىنە=كېپىنەك
ئۈنىمىمىز=ئۈنۈمىمىز
تۆكۈستىن=تۆكۈشتىن
قاچىلىك=قانچىلىك
نەھ=نەق
سالاق=ساۋاق
تەجرىبى=تەجرىبە
ۋولفۇرام=ۋولفرام
تاپاممىدۇق=تاپالمىدۇق
ئاممىسا=ئالمىسا
ئېرىشەممەسلىك=ئېرىشەلمەسلىك
قىلىۋولما=قىلىۋالما
تۇتماقچ=تۇتماقچى
يوغاراق=يوغانراق
پۇشايماق=پۇشايمان
قارىمىقىغا=قارمىقىغا
كەلسەكەن=كەلسىكەن
پەقەتتا=پەقەتلا
بىرمۇچە=بىرمۇنچە
پەللىلەگە=پەللىلەرگە
مۇھتاجتۇر=موھتاجدۇر
نىسبىتەن=نىسبەتەن
تەييارلىقلانى=تەييارلىقلارنى
مايسىلانى=مايسىلارنى
تونۇشتۇرغىنىكەن=تونۇشتۇرغانىكەن
كەممەسكە=كەلمەسكە
كۆسەتمىسەڭ=كۆرسەتمىسەڭ
مۇۋەپپەقىيتىڭگە=مۇۋەپپەقىيىتىڭگە
كانكىرەت=كونكرېت
ئۆتۈنگىنىكەن=ئۆتۈنگەنىكەن
سەبىيىسىگە=سەۋىيەسىگە
تۇتقۇزۇپ=ئۇتقۇزۇپ
سوۋغىتۇم=سوۋغىتىم
ئۆيلەنى=ئۆيلەرنى
كانكېرىت=كونكرېت
چۈشۈنۈشكە=چۈشىنىشكە
بۇرۇچ=بۇرچ
تەجرىبىلە=تەجرىبىلەر
تەربىيىلىنىش=تەربىيەلىنىش
يۇقىرىلغانسېرى=يۇقىرىلىغانسېرى
ئېلىشمىغىچە=ئېلىشمىغۇچە
بەمەي=بەرمەي
ئىستىقبالىڭغىمۇ=ئىستىقبالىغىمۇ
تۈگىنىنى=تۈگۈنىنى
بوساڭمۇ=بولساڭمۇ
بەزىرە=بەزىلەر
ئىتتىرگەنلىكتىن=ئىتتەرگەنلىكتىن
تونىغۇدەك=تونۇغۇدەك
توققۇنۇشنى=توقۇنۇشنى
يۈزىنجى=يۈزىنچى
ھادا=ھالدا
تۇيۇسىدا=تۇيغۇسىدا
شارايىتىڭ=شارائىتىڭ
قىممىسا=قىلمىسا
قانداقلىقدا=قانداقلىقىدا
بوممىساڭ=بولمىساڭ
ھېساببا=ھېسابتا
ئۈمىدلەنى=ئۈمىدلەرنى
پەلەيپىيىنىڭ=پەلەمپىيىنىڭ
مەزىسىز=مەززىسىز
گىرغە=گىرغا
ئوينىنىشىمىز=ئويلىنىشىمىز
قويدىممۇ=قويدۇممۇ
قىمماسلىقىدا=قىلماسلىقىدا
ئويلانمىغانلا=ئويلانمىغانلار
يانپۇن=يانفون
نازرەت=نازارەت
تەجارەتچىلىرىنىڭ=تىجارەتچىلىرىنىڭ
باشقۇرۇس=باشقۇرۇش
ھەقتا=ھەقتە
توختىلۇپ=توختىلىپ
قوللىنىللمايدىكەن=قوللىنىلمايدىكەن
پەۋقۇلاددا=پەۋقۇلئاددە
توسالغا=توسالغۇ
يىگۆرتۈشىگە=يۈگۈرۈشىگە
دېتالدى=دېتالى
قايتۇرۇس=قايتۇرۇش
ئەسكەرتىسكە=ئەسكەرتىشكە
مۇئاشىنىڭ=مائاشىنىڭ
پىرسەنتىگۈچە=پىرسەنتىگىچە
بازادىن=بارادىن
گازىلىق=گازلىق
ھەمخارلاشقاندىن=ھەمكارلاشقاندىن
ئىشلەپچىقىرلاپ=ئىشلەپچىقىرىپ
تۆتىنجىسى=تۆتىنچىسى
گازىق=گازلىق
دەسەپكى=دەسلەپكى
گۈللۈنۈش=گۈللىنىش
خارابلىششىغا=خارابلىشىشىغا
سائىلىدا=ساھىلىدا
مەنلۇم=مەلۇم
يۈلىنۇشلەرگە=يۆلىنىشلەرگە
كۆتەرمىگەن=كۆتۈرمىگەن
ھېسسىياتتى=ھېسسىياتى
مەڭلۇبىيەتنى=مەغلۇبىيەتنى
كۈتۈرەلمەيدۇ=كۆتۈرەلمەيدۇ
قوشدىغانغا=قوشىدىغانغا
قەلىبتىكى=قەلبتىكى
چۇگۇلۇپ=چۇۋۇلۇپ
كېيپىياتى=كەيپىياتى
ھېسىياتىمىز=ھېسسىياتىمىز
پااالىيىتى=پائالىيىتى
ئۇچرەپ=ئۇچراپ
مۇھىن=مۇھىم
تاسادبىي=تاسادىپىي
ئەدەملەر=ئادەملەر
دېيەمەيدىغان=دېيەلمەيدىغان
دەۋېردۇ=دەۋېرىدۇ
يېنە=يەنە
كارىخانچى=كارخانىچى
قىلمدى=قىلمىدى
ئۈمۈتسىز=ئۈمىدسىز
تەسسەۋۋۇر=تەسەۋۋۇر
كوترول=كونترول
ئەيىپلەۋاتقان=ئەيىبلەۋاتقان
ئاللاقاچان=ئاللىقاچان
ئەقىلسىزلىك=ئەقىلسىزلىق
ھۇجۇدىمىزدا=ۋۇجۇدىمىزدا
بىلىقۇت=بىلقۇت
ياشلىرىمىزدە=ياشلىرىمىزدا
قۇلۇقىڭنىگ=قۇلىقىڭنىڭ
چارقىراپ=چىرقىراپ
يۈرۈسەن=يۈرىسەن
قۇلىقىننىڭ=قۇلىقىڭنىڭ
قورتۇم-دە=قورقتۇم-دە
يۆلەنچىكىگە=يۆلەنچۈكىگە
چېگىپ=چىگىپ
قويۇدىغان=قويىدىغان
دەۋاتمەمدۇ=دەۋاتمامدۇ
كۈلىشىپ=كۈلۈشۈپ
كەتكىدەكمۇ=كەتكۈدەكمۇ
ئەمەسكەن-غۇ=ئەمەسكەنغۇ
تېگىگې=تېگىگە
يىتەلمىدىڭما=يىتەلمىدىڭمۇ
مۈڭگىزىگە=مۈڭگۈزىگە
سەرقىرايدۇ=سىرقىرايدۇ
ئوزىچە=ئۆزىچە
ئۆيدەكىلەرمۇ=ئۆيدىكىلەرمۇ
مەدىئەنىڭ=مەدىنەنىڭ
ئۆرۇپ=ئۆرۈپ
كۆرۈنەتنى=كۆرۈنەتتى
مەدىئەنى=مەدىنەنى
نازۈك=نازۇك
مۇئامىللىرىدىن=مۇئامىلىلىرىدىن
تەۋەككلۇلچىلىكى=تەۋەككۈلچىلىكى
سىلىپنى=سىنىپنى
سەۋە=سەۋەب
كولۈشۈپ=كۈلۈشۈپ
قۈتىسى=قۇتىسى
ئۈنىڭ=ئۇنىڭ
بويىۋەتنى=بويىۋەتتى
شۈ=شۇ
ناھىيىلىك=ناھىيەلىك
قويۈپ=قويۇپ
بولۈپ=بولۇپ
كېتىشلىرىچۈ=كېتىشلىرىچۇ
ئوغۈل=ئوغۇل
يوشۈرۈنچە=يوشۇرۇنچە
رۈخسەت=رۇخسەت
قورۈسى=قورۇسى
نەشۋىقات=تەشۋىقات
قورۈدا=قورۇدا
تۇراتنى=تۇراتتى
ناھىپىلىك=ناھىيەلىك
دەرۋازىزى=دەرۋازىسى
قىپغىزىل=قىپقىزىل
مۇشۈ=مۇشۇ
جىددىپلىشىپ=جىددىيلىشىپ
تەلەپبۇزدا=تەلەپپۇزدا
كېلىدىغالىقى=كېلىدىغانلىقى
ئۆگىنەلەيدۈ=ئۆگىنەلەيدۇ
مۇلازىمەن=مۇلازىمەت
ماختاۋاتىدۈ=ماختاۋاتىدۇ
ئويۈن=ئويۇن
دۈلدۇللىرى=دۇلدۇللىرى
ئورۇنلاشتۈرۈپ=ئورۇنلاشتۇرۇپ
مېيمانخانىسى=مېھمانخانىسى
قەدىردانناڭ=قەدىرداننىڭ
كوئەنلون=كۇئىنلۇن
كوەنلون=كۇئىنلۇن
ئوقۈرمەنلىرىمىز=ئوقۇرمەنلىرىمىز
قىزىقمات=قىزىقماي
قوپمايسىنا=قويمايسىنا
چۈشەندۇرەرمەن=چۈشەندۈرەرمەن
ئاچساڭىلار=ئاچساڭلار
مىلىيونېر=مىليونېر
قىزىقتۇرۈپ=قىزىقتۇرۇپ
زورۇقماپلا=زورۇقمايلا
چىقىرىۋاتاتنى=چىقىرىۋاتاتتى
ئۈنتۈپ=ئۇنتۇپ
تورغىبىمۇ=تورغىيىمۇ
كېتىۋاتماىدۇ=كېتىۋاتمامدۇ
ئېپقاچتى=ئەپقاچتى
يۆزلىرىنى=يۈزلىرىنى
شەبئەمنى=شەبنەمنى
ئەسلىئەتتى=ئەسلىتەتتى
تاپغىلى=تاپقىلى
غاراڭ-غۈرۇڭ=غاراڭ-غۇرۇڭ
ئاڭلىۋالغۈم=ئاڭلىۋالغۇم
لىپمۇلىق=لىقمۇلىق
ئالۈچىدەك=ئالۇچىدەك
يۇيشاق=يۇمشاق
يېغىنراق=يېقىنراق
جۆيلۇپ=جۆيلۈپ
جەنئەتتىن=جەننەتتىن
تەرەپنىكى=تەرەپتىكى
ئېقىۋاتغان=ئېقىۋاتقان
چاقنىنىپ=چاقنىتىپ
سايىلغا=سائىلغا
يۈتۈۋاتقان=يۇتۇۋاتقان
چۆچۇپ=چۆچۈپ
كېتىپئۇ=كېتىپتۇ
كەرىنداش=قېرىنداش
پىراك=پىراق
تاگدىمۇ=تەگدىمۇ
ئۇزۇتۇخ=ئۇزىتىش
سايىل=سائىل
كۇمۈش=كۈمۈش
بۈنداق=بۇنداق
ئالامىتنى=ئالامىتى
بېشارىشىدۇر=بېشارىتىدۇر
بۈندىن=بۇندىن
بۇلۈت=بۇلۇت
پۈنۈن=پۈتۈن
يۈمران=يۇمران
كەلمەمدۈ=كەلمەمدۇ
چوڭقۈر=چوڭقۇر
كۈمۇش=كۈمۈش
بەرىكەدلىك=بەرىكەتلىك
بولۈر=بولۇر
دەرەغ=دەرەخ
شۈڭا=شۇڭا
ئانىمۈ=ئانىمۇ
قورقىتىۋەتتىڭ=قورقۇتۇۋەتتىڭ
خەپرىگۈل=خەيرىگۈل
تەرەپكسە=تەرەپكە
ئۈسسۇل=ئۇسسۇل
ھۇرپىيپىپ=ھۈرپىيىپ
يۇرگىچە=يۈرگۈچە
خۈش=خۇش
ئەنسىزلىڭ=ئەنسىزلىك
رىشنىنى=رىشتىنى
ئۆتكۇزۇپتۇ=ئۆتكۈزۈپتۇ
قاتۈرۈپ=قاتۇرۇپ
ساقلىمايننى=ساقلىمايتتى
خۇرجۈنسىز=خۇرجۇنسىز
جاۋۈلداپ=جاۋىلداپ
تۈرمۈش=تۇرمۇش
دەپدىغاننى=دەيدىغاننى
تۇرۈۋالمايتتى=تۇرۇۋالمايتتى
ئولتۇرمايننى=ئولتۇرمايتتى
بولۆپ=بولۇپ
دۆتلۈكىمنى=دۆتلۈكۈمنى
قوياتنى=قوياتتى
بالىلىرىمۈ=بالىلىرىمۇ
تۇنبى=تۇنجى
گۈلنۈر=گۈلنۇر
ئوقۈۋانىدۇ=ئوقۇۋاتىدۇ
سىلىپتا=سىنىپتا
بويەچە=بويىچە
ئەيلەپتتى=ئەيلەتتى
مۇنتەھەم=مۇتتەھەم
سۇغىرىۋائاتتى=سۇغىرىۋاتاتتى
ئويناۋاناتنى=ئويناۋاتاتتى
ئاتاتى=ئاتاتتى
تۇرۈپ=تۇرۇپ
بانۇر=باتۇر
كوكىراپ=كوركىراپ
تېگىدا=تېگىدە
يۈڭ=يۇڭ
قۈرۈلۇش=قورۇلۇش
دۇۋىسىگە=دۆۋىسىگە
ئاسنىغا=ئاستىغا
تۈتۇپ=تۇتۇپ
ئارغامچا-توقىناق=ئارغامچا-توقۇناق
ئوقۈۋاتىدۈ=ئوقۇۋاتىدۇ
بوپىچە=بويىچە
قويۈۋاتقان=قويۇۋاتقان
نېمىلەرنىدۈر=نېمىلەرنىدۇر
كېتەمدۈ=كېتەمدۇ
شىنجىاڭنىڭ=شىنجاڭنىڭ
دوسرلارنىڭ=دوستلارنىڭ
جېلليۈزى=جېلىليۈزى
قازىقىستاننىڭ=قازاقىستاننىڭ
فېبرال=فېۋرال
ئالموتوغا=ئالمۇتاغا
داىرلىرى=دائىرىلىرى
ئىگىلىرىرى=ئىگىلىرى
پومىچچىكلار=پومېشچىكلار
پومىچچىك=پومېشچىك
دۇككىنى=دۇكىنى
دۇككاندىكى=دۇكاندىكى
كۈڭە=كۈنگە
ئۆزگۈرىۋاتاتتى=ئۆزگىرىۋاتاتتى
بىرەرسىنىڭ=بىرەرىنىڭ
گۇرپىمىزدىكى=گۇرۇپپىمىزدىكى
گۇرپا=گۇرۇپپا
پوتبۇل=پۇتبول
گۇرپىلىرى=گۇرۇپپىلىرى
شىنجىئاڭدىكى=شىنجاڭدىكى
تاكاممۇللىشىشقا=تاكامۇللىشىشقا
مەۋجۈتلىغىمىزنى=مەۋجۇتلۇقىمىزنى
چىقىراپ=چىرقىراپ
ۋاختىمىزدا=ۋاقتىمىزدا
شەرلىك=شەھەرلىك
ئۇددۇل=ئۇدۇل
توۋلىغانلىغىدىن=توۋلىغانلىقىدىن
تەبلىق=تەبلىغ
دۇككاندىن=دۇكاندىن
ئوبلاسلتلىق=ئوبلاستلىق
قولگا=قولغا
ۋاختىمدا=ۋاقتىمدا
قوسۇپ=قوشۇپ
ئاپىرۋەتكەندە=ئاپىرىۋەتكەندە
تۇرۇۋالغانلىغىم=تۇرۇۋالغانلىقىم
ھاغىچە=ھارغىچە
يىدىم=يېدىم
ساۋايتى=ساۋايتتى
قانىتالىغىدەك=قانىتالىغۇدەك
مەخسىدىدە=مەقسىتىدە
شەھرىدىك=شەھىرىدىكى
قازىقىستان=قازاقىستان
ئۆزبەكىستان=ئۆزبېكىستان
بىشكەكە=بىشكەككە
بەئەرىشكە=بېرىشكە
دۆۋلەتلەرنىمۇ=دۆلەتلەرنىمۇ
تەستىقلانغىچە=تەستىقلانغۇچە
زۆرۇئۇر=زۆرۈر
كۆرگىسى=كۆرگۈسى
تېرورلۇقنىڭ=تېررورلۇقنىڭ
رايۇنلارغا=رايونلارغا
چېگرىسىدىكى=چېگراسىدىكى
چېگرىسىدىن=چېگراسىدىن
توساقسىز=توسۇقسىز
ئاۋغانىستاندىن=ئافغانىستاندىن
ئۈگۈنۈپمۇ=ئۆگىنىپمۇ
ۋەيرانىچىلىق=ۋەيرانچىلىق
ئارۇ=ئارزۇ
تەئەرورچى=تېررورچى
كۆرسۈتۈشتە=كۆرسىتىشتە
ئاپرۇپىلانلىرى=ئايروپىلانلىرى
ئۇگىسىدا=ئۇۋىسىدا
ئاقىبەتلەرنى=ئاقىۋەتلەرنى
يىمەكلىگىمىز=يېمەكلىكىمىز
ئەنسىرمەسلىگىمىزنى=ئەنسىرىمەسلىكىمىزنى
ئىشەنمەستىنمۇ=ئىشەنمەكتىنمۇ
ئۆزگۈرىۋاتقانلىغىدىن=ئۆزگىرىۋاتقانلىقىدىن
مەسجىتكە=مەسچىتكە
كۆرۇئۇندى=كۆرۈندى
ئىچىيىپ=ئىچىشىپ
قەئەرىنداشلىرىمىز=قېرىنداشلىرىمىز
تاقغلىق=تاقاقلىق
تىنىچلاندۇردى=تىنچلاندۇردى
تىنىچلانماقتىن=تىنچلانماقتىن
ھىچنىمىسىنى=ھېچنېمىسىنى
قىلالايتۇق=قىلالايتتۇق
چۈشكەنلىگىمىزنى=چۈشكەنلىكىمىزنى
ئاغزىمىز=ئېغىزىمىز
سېتىلىۋاتقانلىغىدىن=سېتىلىۋاتقانلىقىدىن
پىشۇرلۇپ=پىشۇرۇلۇپ
ھىيىم=خېيىم
قايسۇ=قايسى
ئەڭە=ئەنگە
بەگەندىن=بەرگەندىن
ساخلاپ=ساقلاپ
ئامەركا=ئامېرىكا
ئامەركىنىڭ=ئامېرىكىنىڭ
ئايرۇدۇرۇمىغا=ئايرودرومىغا
ئەشەددى=ئەشەددىي
تايىغىنىمۇ=تايىقىنىمۇ
پىچىلگەن=پىچىلغان
تۈرمىئىسى=تۈرمىسى
ھەجەپ=ئەجەب
سىمۇنت=سېمونت
قورقۇدىغىنى=قورقىدىغىنى
چارىسىزلىق=چارىسىزلىك
مىلۇدىيەسىنى=مېلودىيەسىنى
قاراڭغۇلىغى=قاراڭغۇلۇقى
ھىلىسىنى=ھىيلىسىنى
كىيگۈزۈلگەن=كىيدۈرۈلگەن
يومۇرماق=يوپۇرماق
ئوففىتسىر=ئوفىتسېر
كەتت=كەتتى
ۋاختىڭدا=ۋاقتىڭدا
مىكراسكوپنىڭ=مىكروسكوپنىڭ
مىكراسكۇپتەك=مىكروسكوپتەك
كۈزەتكەندە=كۆزەتكەندە
ئادەلەتسىزلىگىنىڭ=ئادالەتسىزلىكىنىڭ
جەزىملەشتۈرۈلگەن=جەزملەشتۈرۈلگەن
ئۈگۈتىۋاتقان=ئۆگىتىۋاتقان
جازالايتى=جازالاتتى
توساقلار=توسۇقلار
ۋاختىمۇ=ۋاقتىمۇ
قالىغاچتەك=قارلىغاچتەك
بىڭتۇئەن=بىڭتۇەن
سىمۇتقا=سېمونتقا
فېبرالنىڭ=فېۋرالنىڭ
پاكىزلاۋالىمىز=پاكىزلىۋالىمىز
قۇيرىغىدىكى=قۇيرۇقىدىكى
ساخلىيالىغان=ساقلىيالىغان
ساخلاشقا=ساقلاشقا
يېتىدىغانلىغىغا=يېتىدىغانلىقىغا
چىققانلىغىمىز=چىققانلىقىمىز
ھەتتە=ھەتتا
كۆرۈشەلەيتى=كۆرۈشەلەيتتى
ئېلھام=ئىلھام
غايىمز=غايىمىز
ئاپارغىدەك=ئاپارغۇدەك
ئويلايتۇق=ئويلاپتۇق
سىتالىندىن=ستالىندىن
ئىبارەك=ئىبارەت
ئۈمۈتلەرنى=ئۈمىدلەرنى
چەمبەرچەس=چەمبەرچاس
دەھال=دەرھال
ئاغزىمىزغا=ئېغىزىمىزغا
قويۇۋاتقانلىغىنى=قويۇۋاتقانلىقىنى
تۇرۇغلۇقمۇ=تۇرۇقلۇقمۇ
كۈبا=كۇبا
دۆۋلىتىنىڭ=دۆلىتىنىڭ
پىزىنتى=پرېزىدېنتى
تالىبانل=تالىبان
تېرورچىلىرىنى=تېررورچىلىرىنى
بۈتۈن=پۈتۈن
قىسىلچىلىغىمىز=قىسىلچىقىمىز
كۆرگەنلىگىمىز=كۆرگەنلىكىمىز
مىھرىبانلىغى=مېھرىبانلىقى
مىھرىبانلىغىدىن=مېھرىبانلىقىدىن
تىئى=تىلى
كۆپۈيۈشكە=كۆپىيىشكە
ئارلىغىمىز=ئارىلىقىمىز
قىدۇق=قىلدۇق
ئۆمۈلۈگۈچىلەر=ئۆمىلىگۈچىلەر
كىندىق=كىندىك
ئەشەددىسى=ئەشەددىيسى
شەخىسلەرگە=شەخسلەرگە
چۇگۇلۇشقا=چۇۋۇلۇشقا
مۇسۇنداق=مۇشۇنداق
چۇگىلىدۇ=چۇۋۇلىدۇ
شاھىدلىرىغا=شاھىتلىرىغا
ئارلىسىپ=ئارىلىشىپ
كەتكەڭە=كەتكەنگە
ئەلەيكىسالام=ئەلەيھىسسالام
خىتتايدىن=خىتايدىن
دۇنيادىك=دۇنيادىكى
تەرتىۋىگە=تەرتىپىگە
مەۋجۇتلىغىنى=مەۋجۇتلۇقىنى
دەششەتلىك=دەھشەتلىك
دۆۋلەتلەرنىڭ=دۆلەتلەرنىڭ
دۆۋلەتلىرىنىڭ=دۆلەتلىرىنىڭ
تونىمايمىز=تونۇمايمىز
بەيجىندا=بېيجىڭدا
كوزۇرىنى=كوزىرىنى
ۋاغىڭتون=ۋاشىنگتون
داۋاگەر=دەۋاگەر
ئامەئەركا=ئامېرىكا
ۋاختىنى=ۋاقتىنى
ھەپىشىپ=ھەپىلىشىپ
تېروررىست=تېررورىست
تۇققاندا=تۇغقاندا
دۆۋلەتكە=دۆلەتكە
گۇئانتانامۇدۇكى=گۇئانتانامۇدىكى
ئادۇكات=ئادۋوكات
گىراجدانى=گىراژدانى
ئەرەپنى=ئەرەبنى
ئۈگەڭەن=ئۆگەنگەن
ئالدىگان=ئالدىغان
دۆۋلەتنى=دۆلەتنى
بولۇسىنى=بولۇشىنى
ئالبانىئىيەگە=ئالبانىيەگە
كۆرمىگەنلىگى=كۆرمىگەنلىكى
مەدىنيەتلەرنىڭ=مەدەنىيەتلەرنىڭ
چولۇقاي=چۇلۇقاي
بولغالتىرى=بوغالتىرى
كۆتىرىگە=كۆتۈرىگە
زاۋۇدى=زاۋۇتى
سەۋىت=سوۋېت
سوۋىتلەر=سوۋېتلار
ئالماتا=ئالمۇتا
قارماي=قارىماي
ئىجدىمائى=ئىجتىمائىي
قىئىپ=قىلىپ
ئۆزگۈرۇئۇشلەر=ئۆزگىرىشلەر
باللىلارنىڭ=بالىلارنىڭ
شاراپسىز=شارابسىز
ئۆزگۈرۈشنى=ئۆزگىرىشنى
سىھرى=سېھرى
بىرسىنىڭ=بىرىنىڭ
تەبلىقنى=تەبلىغنى
كلەگەندىن=كەلگەندىن
ئەزالىغىنىڭ=ئەزالىقىنىڭ
باستۇرلىشى=باستۇرۇلۇشى
كېرەكمىتى=كېرەكمىدى
مەلىداشلىرى=مەھەللىداشلىرى
سورۈن=سۆرۈن
تاتلىۋېلىپ=تاتىلىۋېلىپ
گۇرپىسىدىكى=گۇرۇپپىسىدىكى
گۇرپىلىرىنىڭ=گۇرۇپپىلىرىنىڭ
شىنجىئاڭدىن=شىنجاڭدىن
بىلمەيدىغانلىغىم=بىلمەيدىغانلىقىم
بىلمەيتىم=بىلمەيتتىم
ئېيتىلغىچە=ئېيتىلغۇچە
خىتتاينى=خىتاينى
سەبداشلىرى=سەپداشلىرى
كۆۋرۈگىدىكى=كۆۋرۈكىدىكى
ئەرەپچى=ئەرەبچە
ئۆلما=ئۆلىما
ئاچالمىغانلىغى=ئاچالمىغانلىقى
ئازاپلايتى=ئازابلايتتى
ئۈندەيتى=ئۈندەيتتى
ساخلىغانمۇ=ساقلىغانمۇ
ئارلىغىدىكى=ئارىلىقىدىكى
ئۇچۇرشۇپ=ئۇچۇرۇشۇپ
ئىز-دېرىگىنى=ئىز-دېرىكىنى
ئاققۇزىدىغان=ئاقتۇرىدىغان
گۇرپىلىرىدا=گۇرۇپپىلىرىدا
مەسجىتلەردىكى=مەسچىتلەردىكى
تۇشمۇ-تۇشتىن=تۇشمۇتۇشتىن
مەسجىدىدە=مەسچىتىدە
مەسجىتلەر=مەسچىتلەر
يوخلاپ=يوقلاپ
لايھەسىنى=لايىھىسىنى
مەسجىتىنىڭ=مەسچىتىنىڭ
كونكىرىتنى=كونكرېت
مۇۋەپەقىيەتلىك=مۇۋەپپەقىيەتلىك
مەسجىتنىڭ=مەسچىتنىڭ
شەھرلىك=شەھەرلىك
مەسجىتتە=مەسچىتتە
تەربىيەلەڭەن=تەربىيەلەنگەن
رېستۇرانىنىمۇ=رېستورانىنىمۇ
ئېختىسادى=ئىقتىسادى
ئارقىلقتا=ئارىلىقتا
مەسجىت=مەسچىت
كۆيوغلى=كۈيئوغلى
ئىز-دىرىگى=ئىز-دېرىكى
ئىز-دېرىگى=ئىز-دېرىكى
ۋەلسىپىتىنىمۇ=ۋېلىسىپىتىنىمۇ
ئارلاشمايتى=ئارىلاشمايتتى
خوشى=خۇشى
باھسلانغۇچ=باشلانغۇچ
دېرىگى=دېرىكى
يۇقۇردىكىلەر=يۇقىرىدىكىلەر
تۆھمەلەرنى=تۆھمەتلەرنى
شۇغۇللۇنۇپ=شۇغۇللىنىپ
داۋامالشتۇرۇۋاتقان=داۋاملاشتۇرۇۋاتقان
ئەسسالامۇئەلەيكۇمەلەيكۇم=ئەسسالامۇئەلەيكۇم
ئىزنەكلىرىنى=ئىزناكلىرىنى
قەلبىمىمىزدىن=قەلىمىمىزدىن
ئەپات=ئاپەت
بەختسىزلە=بەختسىزلەر
گۆررىدە=گۈررىدە
پۇللاڭلاپ=پۇلاڭلاپ
گۇلە-قاقنى=گۈلە-قاقنى
قويىدۇم=قويدۇم
قورشۇۋالغان=قورشىۋالغان
قارىلدى-دە=قارىدى-دە
مېمە-چىۋە=مېۋە-چېۋە
ئاغزىنىڭ=ئېغىزىنىڭ
ئوچۇندەك=ئوچۇمدەك
دۆپدۆگىلىك=دۈپدۈگىلەك
مۇشىكەن=مۇشۇكەن
ئالىقىندىكى=ئالىقىنىدىكى
زورلاۋاتقىنمىز=زورلاۋاتقىنىمىز
كەمسۈندۈرسەن=كەمسۇندۇرىسەن
ئاغزىڭدىن=ئېغىزىڭدىن
ئەقىتىۋاتىسەم=ئېقىتىۋاتىسەن
سۇمدىن=سومدىن
گۆرجەككە=گۈرجەككە
سۈندۇرۈپ=سۇندۇرۇپ
بولسۈن=بولسۇن
مەدھىيىلەپ=مەدھىيەلەپ
ئۈلۇغلىمامدۇ=ئۇلۇغلىمامدۇ
ئەتراپنىكى=ئەتراپتىكى
كەتنى=كەتتى
دېپىشىپ=دېيىشىپ
قارىماسىلەر=قارىمامسىلەر
بۈزۈلۈشىنى=بۇزۇلۇشىنى
كومىتېتنىنىڭ=كومىتېتىنىڭ
قاش-كۆزلى=قاش-كۆزلىرى
جەڭدۇ=جاڭدۇ
يەتتەنچى=يەتتىنچى
زوڭزۇيۇپ=زوڭزىيىپ
جاپبار=جاپپار
پۈتھۈشۇپ=پۈتۈشۈپ
ئولتۇرغۇنىچە=ئولتۇرغىنىچە
چېۋىن=چىۋىن
نۇشت=مۇشت
پۈركۈنۈپ=پۈركىنىپ
ھايانكەشلە=ھايانكەشلەر
مېھمانخان=مېھمانخانا
ۋېلىسپت=ۋېلىسىپىت
بوھالتىرى=بوغالتىرى
بېرگەن=بەرگەن
ئاتىكارچىلىغىنى=ئاتىكارچىلىقىنى
ھېسابلاشمەيدىكەنلا=ھېسابلاشمايدىكەنلا
سەكرەسەنغۇ=سەكرەيسەنغۇ
ئۆن=ئون
قويۇدىغانلىقىمنى=قويىدىغانلىقىمنى
تاكاللاشقىم=تاكاللاشقۇم
ئاچچىققى=ئاچچىقى
ئۆگۈنىۋېرىدۇ=ئۆگىنىۋېرىدۇ
جەپبار=جاپپار
ھۆپۆپ=ھۆپۈپ
يىقىلىسا=يىقىلسا
يىرتىغۇدەك=يىرتىقىدەك
قىزغىش=قىزغۇچ
لىڭگىر-تاقتاقتىن=لىڭگىرتاقتاقتىن
چاڭجاڭ=چاڭجياڭ
سودى=سودا
چۈشۇشتى=چۈشۈشتى
مېۋە-چەۋە=مېۋە-چېۋە
مەۋە-چىۋە=مېۋە-چېۋە
شىكىتىگە=شىركىتىگە
جەمئىيت=جەمئىي
يۈژ=يۈز
دېمىققاندەك=دىمىققاندەك
سودە=سودا
ئەكېلەمما=ئەكىلەملا
شېخىلمۇ=شېغىلمۇ
كەتكەندىكلا=كەتكەندەكلا
ژورناللاردىكى=ژۇرناللاردىكى
شاپتۇلەك=شاپتۇلدەك
نېمىلەنىدۇر=نېمىلەرنىدۇر
شوتۇسى=شوتىسى
شوۋچىلارنىڭ=شوۋىچىلارنىڭ
قىشىۋالساق=قىسىۋالساق
ئاقتىكارچى=ئاتىكارچى
مونچىدىن=مۇنچىدىن
خىلدە=خىلدا
يۆلەنچۈگىگە=يۆلەنچۈكىگە
سوس=سۇس
باشلىقنىن=باشلىقنىڭ
ئېھتىياجىق=ئېھتىياجلىق
ئىسلىھاتچىلار=ئىسلاھاتچىلار
پاراۋۇزىنى=پاراۋوزىنى
دەشتىلەرنى=دەشتلەرنى
پىستا-بادام=پىستە-بادام
بولغار=بۇلغار
پەشلادا=پەشۋادا
دېدىمدە=دېدىم-دە
ئاڭلىغانمىسەن=ئاڭلىغانمۇسەن
گارۋان=كارۋان
جېيەكلىك=جىيەكلىك
ئۇۋلاۋېتىپ=ئۇۋىلاۋېتىپ
سەمىرىدىمىكىن=سەمرىدىمىكىن
سەۋر-تاقەتلىق=سەۋر-تاقەتلىك
ئاللاھ=ئاللا
ئۆتتۈشۈپ=ئۆتۈشۈپ
تورىسىدا=تورۇسىدا
تۇيمايا=تۇيمايلا
ھاجىن=ھاجىم
مارقىلىق=ماركىلىق
ھاجىڭنىڭ=ھاجىمنىڭ
ئىشپۇيونلۇققا=ئىشپىيونلۇققا
ئاغزىڭ=ئېغىزىڭ
تەگكۈزۋاتىسىنا=تەگكۈزۈۋاتىسىنا
جاپار=جاپپار
بېنىزىن=بېنزىن
دىماگلارغا=دىماغلارغا
رېمۇتخانىغا=رېمونتخانىغا
ئاپاسام=ئاپارسام
ياقۇب=ياقۇپ
ئەديال=ئەدىيال
ياگاچ=ياغاچ
جەينىمازدىن=جاينامازدىن
بوسۇغۇسى=بوسۇغىسى
تومۇقاپ=تۇمۇقاپ
قورغۇم=قۇرغۇم
يۇرتۇقلار=يۇرتلۇقلار
زۇۋاللىققا=زاۋاللىققا
ئاگلىتىمىز=ئاڭلىتىمىز
شىنخۇۋا=شىنخۇا
دېەقانچىلىق=دېھقانچىلىق
تۈنۈگىن=تۈنۈگۈن
كەگىنىچە=كەلگىنىچە
ئۈزۈكە=ئۈزۈككە
رەڭجىمىدى=رەنجىمىدى
سۈيۈشتىن=سۆيۈشتىن
براۋنى=بىراۋنى
يېكشەنبىللەردە=يەكشەنبىلەردە
قولۇمقا=قولۇمغا
دوستۇن=دوستۇم
ئابدىغېنى=ئابدۇغېنى
مىننەتار=مىننەتدار
ئەسكەتكەن=ئەسكەرتكەن
ئەنسىرەيتىم=ئەنسىرەيتتىم
گېپ=گەپ
سۈيۈشۈم=سۆيۈشۈم
سورايىتىڭ=سورايتتىڭ
ئەمەنسەن=ئەمەسسەن
بارگۇ=بارغۇ
قىلىۋالىدىڭ=قىلىۋالدىڭ
ئاشقىم=ئاشىقىم
قاخشاشلارغا=قاقشاشلارغا
ئاششىقلىقنى=ئاشىقلىقنى
ئاشسىقلىق=ئاشىقلىق
كۈيەلمەيدىغان=كۆيەلمەيدىغان
ۋاقىتىڭنىمۇ=ۋاقتىڭنىمۇ
ئىشەنچەڭ=ئىشەنچىڭ
كۆيۈمە=كۆيمە
بۇلمىسا=بولمىسا
بۈلۈمىگە=بۆلۈمىگە
يېلىنغىنچە=يېلىنغىنىچە
يۈرىڭە=يۈرۈڭە
دوختارلار=دوختۇرلار
بۆلىمىگە=بۆلۈمىگە
يۈمەيدۇ=يۈرمەيدۇ
ئىشكىرىگە=ئىچكىرىگە
رەجەب=رەجەپ
نەيچىلەرى=نەيچىلەرنى
ۋىراچنىڭ=ۋراچنىڭ
ساددى=ساددا
مەدىھىيلىنىدۇ=مەدھىيەلىنىدۇ
ئۇچۇقاراق=ئوچۇقراق
ئادەمنۇ=ئادەممۇ
ئاسانلى=ئاسانلا
خوتەڭە=خوتەنگە
ئوينىچىلىقى=ئويمىچىلىق
بۈلۈمىدىكى=بۆلۈمىدىكى
ئىسپاتنامى=ئىسپاتنامە
ئەتىگەڭدە=ئەتىگەندە
يەرلەگە=يەرلەرگە
شوۋاگۈرۈچ=شوۋىگۈرۈچ
پىشۇرۇغان=پىشۇرۇلغان
ئۈستىگى=ئۈستىگە
شوركىنىڭ=شورپىنىڭ
ئىشقىلىق=ئىشقىلىپ
ئېشنى=ئېشىنى
تاپمىداڭ=تاپمىدىڭ
كەتتەن=كەتكەن
دادەم=دادام
ئىزلىگەنلىكى=ئىزدىگەنلىكى
شۇپىغا=سۇپىغا
كانىيىمگە=كانىيىمغا
چەكەن=چەككەن
يۇلتۇزلارزغا=يۇلتۇزلارغا
مۇرلاپ=مورلاپ
كاۋابچىلارغا=كاۋاپچىلارغا
رىسقىم=رىزقىم
كېلۈشى=كېلىشى
ئاۋۇندۇرغىنىنغا=ئاۋۇندۇرغىنىڭغا
تەجارەتچى=تىجارەتچى
گۇيا=گويا
ئۇلاغلاشلار=ئۇلۇغلاشلار
يورۇتمۇسا=يورۇتمىسا
چېنىدەكلا=چىنىدەكلا
ھۈنرى=ھۈنىرى
ھېلھەم=ھېلىھەم
خوتەننىكى=خوتەندىكى
ياشلەر=ياشلار
ئۆي-بېسات=ئۆي-بىسات
مېھر-شەپقەتلىرى=مېھىر-شەپقەتلىرى
بالايى-بەتتەرلىرى=بالايىبەتتەرلىرى
ئېچىنمەيدۇ=ئېچىنمايدۇ
پەلەمپەيلە=پەلەمپەيلەر
كۆزا=كوزا
چىنەر=چىنار
كۆكەتلىش=كۆكەرتىش
ھىدە=ھىدى
قىلغاش=قىلغاچ
تۇنۇيالمىغىلى=تونۇيالمىغىلى
قولۇۋالغانىدى=قويۇۋالغانىدى
كاۋابداندىن=كاۋاپداندىن
دولۇسىدىن=دولىسىدىن
ھەجەب=ئەجەب
ھوشھيار=ھوشيار
بولغاندىما=بولغاندىمۇ
دەۋەتقىنىنى=دەۋاتقىنىنى
قويىڭە=قويۇڭە
كېلەمدىكى=كېلەمدىكىن
چىنەلەرگە=چىنىلەرگە
تونۇدىڭمۇ=تونۇدۇڭمۇ
گالدۇ-گۇلدۇڭ=گالدى-گۇلدۇڭ
نېمەدۇر=نېمىدۇر
كومەتىتىغا=كومىتېتىغا
بەھھۇزۇر=بەھۇزۇر
ئەقىل-ئىدرىكىڭنىڭ=ئەقىل-ئىدراكىنىڭ
چېگرىدىن=چېگرادىن
پۆۋلەپ=پۈۋلەپ
ئىشكەچ=ئىچكەچ
ئىلگىر-ئاخىر=ئىلگىرى-ئاخىر
يەكەنلەكگە=يەكەنلەرگە
خېمىيىۋى=خىمىيەۋى
سېمۇنت=سېمونت
ئويلەپسەن=ئويلاپسەن
ئورۇندۇقا=ئورۇندۇققا
قېدىردان=قەدىردان
قىنالدىلىمۇ=قىينالدىلىمۇ
كۈتۈۋالقان=كۈتۈۋاتقان
ئۇنتىلىپ=ئۇنتۇلۇپ
بىرمەيلا=بىلمەيلا
پىسەنتتىڭگە=پىسەنتىڭگە
بالىلارىنىڭ=بالىلارنىڭ
بۈلۈمىدە=بۆلۈمىدە
قاۋەتتىكى=قەۋەتتىكى
ئۇشتۇۋېتىپ=ئوشتۇۋېتىپ
قولمىغان=قويمىغان
چېكىۋاتەمسەن=چېكىۋاتامسەن
تاشلىيالمىدىڭما=تاشلىيالمىدىممۇ
ئاكاسىغا=ئاكىسىغا
پۈتۈرىدىغان=پۈتتۈرىدىغان
پاراكتىكا=پراكتىكا
ئايرودۇرۇمىغا=ئايرودرومىغا
شىۋىسىدا=شېۋىسىدە
شومكىمىزدىن=سومكىمىزدىن
سۇنىقىدەك=سۇنۇقىدەك
سوراخاندا=سوراقخانىدا
يۈرگىچە=يۈرگۈچە
ئەلللىككە=ئەللىككە
بىلەلمىدىڭلاما=بىلەلمىدىڭلارمۇ
ئاشقازنىڭلار=ئاشقازىنىڭلار
يېرىۋەتىدۇ=يېرىۋېتىدۇ
ئەسلىرگە=ئەسلىرىگە
ئۇۋۇلىغىڭىچە=ئۇۋۇلىغىنىچە
قورسۇقدىكى=قورسىقىدىكى
گۇنۇھى=گۇرۇھى
شوراق=سوراق
بىرجەككە=بۇرجەككە
ئىستاقان=ئىستاكان
نەشرىياتتى=نەشرىياتنى
شىڭخۇا=شىنخۇا
كىتابخانلىرىنا=كىتابخانلىرىدا
پروگراممىزنى=پروگراممىمىزنى
بولغاچلا=بولغاچقا
ۋارىسچان=ۋارىسجان
بۆلىمىنىڭ=بۆلۈمىنىڭ
مۇلدىرى=مۇدىرى
قاتلاممۇقاتنام=قاتلاممۇقاتلام
كاتىپات=كاتىبات
جىمىيىدۇ=جىمىيدۇ
قۇرۇلتايىغا=قۇرۇلتايغا
قۇددى=خۇددى
ۋىلايات=ۋىلايەت
ئوبلاسلارنىڭ=ئوبلاستلارنىڭ
مەيدىشىگە=مەيدىسىگە
قۇرۇلتاغا=قۇرۇلتايغا
شۇڭاشقا=شۇڭلاشقا
سەبداشلار=سەپداشلار
سۆھپەتتە=سۆھبەتتە
نۇپتىغا=نۇقتىغا
ئۆزمەي=ئۈزمەي
قاپدەك=قاپتەك
شىلتىغىنىچىپ=شىلتىغىنىچە
مەملىگەپكە=مەملىكەتكە
كاللىشىپ=گاللىشىپ
قالادىغان=قالىدىغان
مۇئاشقىمۇ=مائاشقىمۇ
ھۈگۈمەت=ھۆكۈمەت
تەجىربىلىرىڭىزنا=تەجرىبىلىرىڭىزنى
چاۋاب=چاۋاك
كۆكشىگە=كۆكسىگە
شەپەردە=سەپەردە
يالداشلار=يولداشلار
ئۆتىنەي=ئۆتۈنەي
ئىكىى=ئىككى
ماڭلىغان=مىڭلىغان
جىمنىدە=جىممىدە
كىچىلىتىلگەن=كىچىكلىتىلگەن
شارغۇچ=سارغۇچ
خۇرسۇندى=خورسىندى
خۇرسۇنىشىغا=خورسىنىشىغا
تىزمىلىرىى=تىزمىلىرى
قەبىگە=قەلبىگە
قالدۇرىماي=قالدۇرماي
ئازۇسى=ئارزۇسى
ئۆمۈز=ئۆمۈر
سۇڭدىشىپ=سوڭدىشىپ
ئاقكۆڭۈل=ئاق كوڭۇل
كۆڭۈگلۈكى=كۆڭۈللۈكى
ئىسئاق=ئىسھاق
تېكەستىككى=تېكەستىكى
ۋارىسچام=ۋارىسجان
قەددىي=قەددى
سەپىرنىنمۇ=سەپىرىنىمۇ
شەيخقە=شەيخكە
باسلىغۇچىنىڭ=باشلىغۇچىنىڭ
تۈجۈپۈلۈپ=تۈجۈپىلەپ
تەرەپچان=تەلەپچان
يىلايەت=ۋىلايەت
نېفىتىككە=نېفىتلىككە
ئىنژېلېردىن=ئىنژېنېردىن
ناۋزۇك=نازۇك
چىرتيۇژ=چېرتيوژ
فاكولتەتىنى=فاكۇلتېتىنى
نېفت=نېفىت
مەسئۇلىياتچانلىقى=مەسئۇلىيەتچانلىقى
تەربىيىەلەشنى=تەربىيەلەشنى
تېخلىك=تېخنىك
تەبىيىلەپ=تەربىيەلەپ
ۋارسجان=ۋارىسجان
كۈچۈ=كۈچى
كىرگۈزەللىسەك=كىرگۈزەلىسەك
ئىشىچلار=ئىشچىلار
تەربىيىلەپ=تەربىيەلەپ
تەربىيىلىنىشتىن=تەربىيەلىنىشتىن
نەپار=نەپەر
شىخەنزۇ=شىخەنزە
يۆتۈلۈپ=يۆتىلىپ
ئۆلگەنسەڭ=ئۆگەنسەڭ
بىرەيلەنىڭ=بىرەيلەننىڭ
ۋارىسچاننى=ۋارىسجاننى
تەرساممۇ=تەرسامۇ
كۆردىدە=كۆردى-دە
گاچچىگە=گاچچىدە
تەپسىلىك=تەپسىلىي
مەسىھەتلىشىپ=مەسلىھەتلىشىپ
ئۇنىۋېرسىتەت=ئۇنىۋېرسىتېت
تۇتھۇشۇم=تۇتۇشۇم
ماسلاشىپ=ماسلىشىپ
بەرگىنىنلارغا=بەرگىنىڭلارغا
خۇلدى=خۇددى
روسلارغا=رۇسلارغا
ۋىللىدەە=ۋىللىدە
كەڭ-كۇشادا=كەڭ-كۇشادە
پۇرۇلۇتارىيات=پرولېتارىيات
نەزىرىيىۋى=نەزەرىيەۋى
داھىيىسىنىڭ=داھىيسىنىڭ
بىيۇرو=بيۇرو
چىقارماسىقىم=چىقارماسلىقىم
رەھبەرلىر=رەھبەرلىرى
چونغۇ=چوڭغۇ
ۋارىسچاننىڭ=ۋارىسجاننىڭ
بەستىك=بەستلىك
باشقۇلۇش=باشقۇرۇش
كۆرلۈشۈپ=كۆرۈشۈپ
سىپائىلىك=سىپايىلىك
زىياسىي=سىياسىي
كېنىشكىسنى=كىنىشكىسىنى
يەيدە=يەردە
مۇھەممەدجان=مۇھەممەتجان
كۆندۈزدىكى=كۈندۈزدىكى
بۈككىنە=بۆككىنە
ئولغىيىپ=ئۇلغىيىپ
مەسلىگى=مەسلىكى
زالۋا=زىلۋا
غوۋا=غۇۋا
بەمىدى=بەرمىدى
ئىچكىرلەشنى=ئىچكىرىلەشنى
ئىككىڭلەرنىڭ=ئىككىڭلارنىڭ
قۇشقاچدەك=قۇشقاچتەك
سونىۋېتىپ=سۇنۇۋېتىپ
رېنا=رەنا
ئۇزارتقۇن=ئۇزارتقۇم
رېنانىڭ=رەنانىڭ
نېمىلارنىڭ=نېمىلەرنىڭ
رېنانى=رەنانى
مۇئەمىلە=مۇئامىلە
ئۆلتۈرغانلارنىڭ=ئولتۇرغانلارنىڭ
يانچۇقۇمگدىكى=يانچۇقۇمدىكى
جېم=جەم
يوشۇردىم=يوشۇردۇم
تەنچ=تىنچ
تەسەۋۇرۇمدىكى=تەسەۋۋۇرۇمدىكى
قىز-ئىگىتلەر=قىز-يىگىتلار
قىسمىتتە=قىسمەتتە
قېغىزدىكى=قەغەزدىكى
ئاغىزىم=ئېغىزىم
يېزىدە=يېزىدا
ھاياتتە=ھاياتتا
قالىۋەردىم=قېلىۋەردىم
نىمىشىقىدۇر=نېمىشقىدۇر
مۇھاببەتنىڭ=مۇھەببەتنىڭ
ئەيبكە=ئەيىبكە
كېلەچىگى=كېلەچىكى
دەسلەپكە=دەسلەپكى
پۈتۈرۈشنىڭ=پۈتتۈرۈشنىڭ
چوقۇراشقىنىچە=چۇرقىراشقىنىچە
داستىخانىلىرىغا=داستىخانلىرىغا
تۇتقۇنىچە=تۇتقىنىچە
ئولتۈرۈشمۇ=ئولتۇرۇشمۇ
ئىسكەنچىسىگە=ئىسكەنجىسىگە
رېسمىي=رەسمىي
داستخاننىڭ=داستىخاننىڭ
يېندا=يېنىدا
خۇدايم=خۇدايىم
بىزدىڭ=بىزدىن
قاچ-قۇچىلارنى=قاچا-قۇچىلارنى
بولسىگۇ=بولسىغۇ
مەممۇ=مەنمۇ
خۇلۇقلىرى=خۇلقلىرى
مۇنۇتلاردا=مىنۇتلاردا
ئۆيلار=ئويلار
مىختەق=مىختەك
باتۈر=باتۇر
يۈرۈمسۇن=يۈرمىسۇن
كۆتەرگۈچىلىكى=كۆتۈرگۈچىلىكى
دەيىمىز=دەيمىز
ئېتىزدىڭ=ئېتىزدىن
ئۆزىرە=ئۆزرە
ئىچىمگدە=ئىچىمدە
بەمىسەم=بەرمىسەم
دۇلتارنى=دۇتارنى
چاغىنىمدىن=چالغىنىمدىن
ساھىپخانىلار=ساھىبخانىلار
ئادرويىدا=ئابرۇيىدا
ھەسىرەتسىز=ھەسرەتسىز
قوغۇلۇشۇپ=قوغلىشىپ
گېدىيىۋالمەي=گىدىيىۋالماي
يولۋەس=يولۋاس
ھېش=ھېچ
رېسالەتتىن=رىسالەتتىن
كاجىلىقى=كاجلىقى
دېگەڭە=دېگەنگە
قاخشىغۇچە=قاقشىغۇچە
قاغايسەنغۇ=قارغايسەنغۇ
شۈبھىيلەنمەيتتى=شۈبھىلەنمەيتتى
قوشنا-قولۇملار=قوشنا-قۇلۇملار
تەسەۋۇرۇمدا=تەسەۋۋۇرۇمدا
رۇھسارى=رۇخسارى
تەۋدىشى=تەڭدىشى
ئارتىسىلىرى=ئارتىسلىرى
روھسارى=رۇخسارى
پۇچىلالماي=پۇچىلانماي
يۈرىكىن=يۈرىكىم
ساراسىمىدا=ساراسىمىدە
ئاغىزىمدىن=ئېغىزىمدىن
ئەۋەتكىم=ئەۋەتكۈم
رىسسالەتلا=رىسالەتلا
ئىتايىن=ئىنتايىن
ئاغىزىدا=ئېغىزىدا
قويۇمىزمۇ=قويىمىزمۇ
كۆڭلۈڭىزدىكىنى=كۆڭلىڭىزدىكىنى
تاشلىۋەتكىم=تاشلىۋەتكۈم
جېلىليۇزدىكى=جېلىليۈزىدىكى
خىرۇم=خۇرۇم
ھەقىقدىكى=ھەققىدىكى
كيىم-كېچەك=كىيىم-كېچەك
رادىيومىز=رادىئومىز
پۈتكۈزىشىمىز=ئۆتكۈزۈشىمىز
تىكەلىدىم=تىكەلمىدىم
ياردملىشىپ=ياردەملىشىپ
جېگىدىلەردىن=جىگدىلەردىن
ئالچاغلاپ=ئالچاڭلاپ
قېپىپ=قېتىپ
كامانىڭ=كامارنىڭ
كاماغا=كامارغا
قۇلۇبلار=قۇلۇپلار
رەڭمۇرەنڭ=رەڭمۇرەڭ
سوۋغۇسى=سوۋغىسى
تېگىشىۋەلىپ=تېگىشىۋېلىپ
زىلچە=زىلچا
ئېشاكنى=ئېشەكنى
ئۆلگىتىپ=ئۆگىتىپ
تۈگىمەنچى=تۈگمەنچى
ئېشىكىكە=ئېشىكىگە
تونۇش-بىلەشلەرنى=تونۇش-بىلىشلەرنى
بوۋايھا=بوۋايغا
ئۆگزۈگە=ئۆگزىگە
توپا-چانغا=توپا-چاڭغا
ئابدىرشىت=ئابدۇرېشىت
قەتلى=قەتل
تۇتۇس=تۇتۇش
قەخرىمان=قەھرىمان
ئاۋىسترالىيەدە=ئاۋسترالىيەدە
ئىككىنجىسىنى=ئىككىنچىسىنى
بۈتۈنلەي=پۈتۈنلەي
مىليۇنغىچە=مىليونغىچە
ئىنقىلاۋىنى=ئىنقىلابىنى
ئارلىغىدا=ئارىلىقىدا
پىرىزىنتى=پرېزىدېنتى
شېھىتلىگە=شېھىتلىرىغا
يەتكۇئۇزگۈم=يەتكۈزگۈم
شېھىتلەر=شېھىتلار
كۆرۈلۇئۇشكە=كۆرۈلۈشكە
دىگەنلىگىم=دېگەنلىكىم
سۇنايلىرىنىڭ=سۇنايلىرىنىڭ
يۈرگۈزۈۋاتقانلىغى=يۈرگۈزۈۋاتقانلىقى
ھېمىرىغا=خېمىرىغا
تۆكتىم=تۆكتۈم
ئابدۇخائىق=ئابدۇخالىق
پىلتسى=پىلتىسى
ئازاپلىناتتىم=ئازابلىناتتىم
تولغۇناتتىم=تولغىناتتىم
دۇنيارىمنىڭ=دۇنيايىمنىڭ
پەنپەئەتلەرنى=مەنپەئەتلەرنى
تۇرماسلىقلىق=تۇرماسلىق
كۆينىگىمىزنى=كۆيگىنىمىزنى
قلدى=قىلدى
كېتىۋاتقانلىغىمىزنى=كېتىۋاتقانلىقىمىزنى
قاراڭغۇلىغىنى=قاراڭغۇلۇقىنى
يوقىمايدىغانلىغىغا=يوقىمايدىغانلىقىغا
يەھۇدىنىڭ=يەھۇدىينىڭ
تۇرۇۋالغانلىغى=تۇرۇۋالغانلىقى
قىرغىنچىلىغىدىمۇ=قىرغىنچىلىقىدىمۇ
مەۋجۈتلىغى=مەۋجۇتلۇقى
چېچىلمىغانلىغىنى=چېچىلمىغانلىقىنى
رەنجىيەلمەيمىز=رەنجىيەلەيمىز
دارا-دەرمەكلەر=دورا-دەرمەكلەر
ھېمىر=خېمىر
سەبىر-تاقەت=سەۋر-تاقەت
تۈككەندەك=تۈگكەندەك
ھۈركىيدىغان=ئۈركۈيدىغان
تىنجىغاندا=تىنچىغاندا
تاما=تامە
يەئەڭى=يېڭى
سىزالايدىغانلىغىمىزنى=سىزالايدىغانلىقىمىزنى
پىقىرتىپ=پىرقىرىتىپ
ھەركەتتەك=ھەرىكەتتەك
شۇڭغىيالايدىغان=شۇڭغۇيالايدىغان
مەسۇليەتسىزلىگىمىز=مەسئۇلىيەتسىزلىكىمىز
يلى=يىلى
سېتىۋېلىنغانلىغى=سېتىۋېلىنغانلىقى
ئىشلارنىگ=ئىشلارنىڭ
مەرغۇم=مەرھۇم
يىغاپ=يىغلاپ
ئۆتۈڭەن=ئۆتۈنگەن
چىقالغىلى=چىقارغىلى
يۆلەنچۈگۈم=يۆلەنچۈكۈم
ھۆرمەتلېيتتىم=ھۆرمەتلەيتتىم
قوققان=قورققان
شۈيدۈكى=سۈيدۈكى
كۆينۈپ=كۆيۈنۈپ
كىچىگىڭدىن=كىچىكىڭدىن
ھايدىۋەتكەن=ھەيدىۋەتكەن
ئۆيەڭدە=ئۆيۈڭدە
ياندۇرغىدەك=ياندۇرغۇدەك
باقسان=باقساڭ
ئاغىز=ئېغىز
بۇرنىڭنى=بۇرنۇڭنى
ئىتەر=ئېتەر
تۇغلۇپ=تۇغۇلۇپ
سودىگەچلىك=سودىگەرچىلىك
سۆزلەنىڭ=سۆزلەرنىڭ
قىزقاتتىم=قىزىقاتتىم
مىننەتدارلىقىنىنى=مىننەتدارلىقىمنى
ئايرىلىغۇم=ئارىلىغۇم
چىقماسلىقىڭدان=چىقماسلىقىڭدىن
ھاللىتىمنى=ھالىتىمنى
ئېشىنىشلىق=ئېچىنىشلىق
شۇنچۇۋالا=شۇنچىۋالا
ئېغزىمنى=ئېغىزىمنى
ۋەزنىلىك=ۋەزىنلىك
تىچ-ئامانلىق=تىنچ-ئامانلىق
ھەممەيلەرگە=ھەممەيلەنگە
قورسقىمىز=قورسىقىمىز
تېلېۋىزارغا=تېلېۋىزورغا
تۇتۈن=تۈتۈن
ئوغۇۋاتقان=ئوقۇۋاتقان
شاپلاقتىن=شاپىلاقتىن
چۈشۇڭ=چۈشۈڭ
كۆرگلىكىڭنى=كۆرگۈلۈكۈڭنى
سونكا=سومكا
قولغۇدەك=قويغۇدەك
چىقشىم=چىقىشىم
ماندۇق=ماڭدۇق
ئويلاۋاتلسا=ئويلاۋاتسا
ئىبلىسلانىڭ=ئىبلىسلارنىڭ
دەيتىم=دەيتتىم
ئۆيۇن=ئويۇن
ئۇزۇنغۇچە=ئۇزۇنغىچە
ماۋلان=مەۋلان
ئۈچىن=ئۈچۈن
تۈگلۈپ=تۈگۈلۈپ
سەنتۈرلۈپ=سەنتۈرۈلۈپ
يەردەن=يەردىن
تۇرغۇچىلىكىم=تۇرغۇچىلىقىم
ماۋلانغا=مەۋلانغا
يۈرىيمىز=يۈرىمىز
بىرنەچچ=بىرنەچچە
تەرىققىدە=تەرىقىدە
ئادتىمگە=ئادىتىمگە
خاراجەتلىرىمىز=خىراجەتلىرىمىز
ئانچە-مۇچە=ئانچە-مۇنچە
تىڭ-تىڭلاپ=تىڭتىڭلاپ
كۈنلەگىچە=كۈنلەرگىچە
تاڭسىخانىغا=تانسىخانىغا
بۇيرۇتىلغان=بۇيرۇتۇلغان
باشلايدى=باشلايلى
قىقاس-چۇقان=قىيقاس-چۇقان
مەسخۇش=مەستخۇش
ئوڭايسىزلىقتان=ئوڭايسىزلىقتىن
پىلاستىكىنى=پلاستىنكىنى
قەدەملىرىمىدىن=قەدەملىرىمدىن
ئۇچرۇتالماي=ئۇچرىتالماي
كېلسەم=كەلسەم
كېتكۈدەك=كۈتكۈدەك
ئوغان=ئوغام
ھوشۇنغا=ھوشۇڭغا
رەھىمى=رەھىمنى
ئىنساۋىغا=ئىنساپىغا
تاشىۋەتكەنلىكىنى=تاشلىۋەتكەنلىكىنى
تەنخالىق=تەنھالىق
كېتكەن=كەتكەن
تولىۋېتىپتىمەن=توۋلىۋېتىپتىمەن
زۈھرە=زۆھرە
مەھەببەتنىڭ=مۇھەببەتنىڭ
سوغاقلارنى=سوغۇقلارنى
قورسۇقۇم=قورسىقىم
يېۋالغان=يەۋالغان
گېپمىزنىڭ=گېپىمىزنىڭ
كېلمەن=كېلىمەن
يېردە=يەردە
تەبەسسۇن=تەبەسسۇم
قۇچاقدىم=قۇچاقلىدىم
ئېرىشىۋىدىم=ئېرىشىۋېدىم
دۇدۇقلىغنىمچە=دۇدۇقلىغىنىمچە
چاقانلىشىپ=چاققانلىشىپ
ھىسىياتىم=ھېسسىياتىم
زۆھرەرنىڭ=زۆھرەنىڭ
سۆيەتتىنغۇ=سۆيەتتىڭغۇ
ئۆزەڭچۇ=ئۆزۈڭچۇ
ئولتارغاچ=ئولتۇرغاچ
مەيھانىغا=مەيخانىغا
سۆزىسەڭچۇ=سۆزلىسەڭچۇ
ئويغۇتىۋەتمەسلىك=ئويغىتىۋەتمەسلىك
يۈېن=يۈەن
تۇتلۇپ=تۇتۇلۇپ
ناھايھى=ناھايىتى
بىرىمىزىڭ=بىرىمىزنىڭ
يىقېن=يېقىن
سەرگۈزەشلىرىمىزنى=سەرگۈزەشتلىرىمىزنى
جۆر=جور
پۈتۈشىپ=پۈتۈشۈپ
بەخلىك=بەختلىك
دېيىسىچە=دېيىشىچە
باشلىدىن=باشلىدىم
ئانلىغۇچىلار=ئاڭلىغۇچىلار
پېشىۋالارنىڭ=پېشۋالارنىڭ
ياسلىق=ياشلىق
تۇيغۇنلىرىمدا=تۇيغۇلىرىمدا
چاغداكى=چاغدىكى
مەجمۇنلارچە=مەجنۇنلارچە
سۇنداقلا=شۇنداقلا
گۇڭۇر-مۇڭۈر=گۇڭۇر-مۇڭۇر
شىلكىشىدىن=سىلكىشىدىن
بېشىمگدا=بېشىمدا
ئۆڭسىلى=ئۆڭسۈلى
تەڭرىقاپ=تېڭىرقاپ
سۈتكىنىمچە=سۈرتكىنىمچە
چەڭچىلەر=جەڭچىلەر
پۈرلەندىم=پۈركەندىم
لىيەنجاڭنى=ليەنجاڭنى
لىيەنجاڭنىڭ=ليەنجاڭنىڭ
گورۇستاندەك=گۆرىستاندەك
ئالدىرغانسېرى=ئالدىرىغانسېرى
لىيەنجاڭ=ليەنجاڭ
قويغىدەك=قويغۇدەك
ئىشكىرلەپ=ئىچكىرىلەپ
كۆسەتكۈدەك=كۆرسەتكۈدەك
تۇيغۇملىرىمنى=تۇيغۇلىرىمنى
كەچۈرمىشىلەرنى=كەچۈرمىشلەرنى
بولۇۋاتسەن=بولۇۋاتىسەن
پۇشقىقىنى=پۇچقىقىنى
بوشۇتۇپ=بوشىتىپ
تۇرۇغۇدەك=تۇرغۇدەك
قەپسىدىن=قەپىسىدىن
كۆرۈڭۈدەك=كۆرۈنگۈدەك
پاقالچىكىمنى=پاقالچىقىمنى
پاقالچىغىمنىڭ=پاقالچىقىمنىڭ
ۋەنتىسىنى=ۋىنتىسىنى
ۋارقىرغۇدەك=ۋارقىرىغۇدەك
قولتۇقۇغا=قولتۇقىغا
قورقۇنۇچ=قورقۇنچ
نېۋىلىرىمنى=نېرۋىلىرىمنى
كەچۈرمۈشلىرىمنى=كەچۈرمىشلىرىمنى
قوزغۇندەك=قۇزغۇندەك
لىيەنىدە=ليەنىدە
چۈسكەن=چۈشكەن
كۆتۈرۈلۇۋاتقانلىقىنى=كۆتۈرۈلۈۋاتقانلىقىنى
نەچكە=نەچچە
كۆردۈق=كۆردۇق
لىيەنجاڭدىن=ليەنجاڭدىن
قوشىمىلىرى=قوشۇمىلىرى
كۆتۈرۈلىگەن=كۆتۈرۈلگەن
توغاشتەك=توغاچتەك
لىيەنجاڭغا=ليەنجاڭغا
ھەممەيلەرنىڭ=ھەممەيلەننىڭ
خاداغا=خۇداغا
ئىشىقىلىپ=ئىشقىلىپ
تۆنۈگۈنمۇ=تۈنۈگۈنمۇ
تېلەفوندا=تېلېفوندا
ئادەمىيلىكىم=ئادىمىيلىكىم
مەھلىيە=مەھلىيا
بەرگىلىرى=بەرگلىرى
سىزمىتىڭىز=سىزمىدىڭىز
دىخاۋۇدا=دۇخاۋىدا
چىقىرىۋەتىڭىزغۇ=چىقىرىۋەتتىڭىزغۇ
تېلەفون=تېلېفون
ئارىمىزىغا=ئارىمىزغا
ئاشكارىلىۋاتاتتى=ئاشكارىلاۋاتاتتى
نىمەگىدۇر=نېمىگىدۇر
ھالراڭ=ھالرەڭ
ئەكىلەپ=ئەركىلەپ
ئايرودۇرۇمدا=ئايرودرومدا
ئۈلگىرەلمىگەن=ئۈلگۈرەلمىگەن
سۈركۈلۈش=سۈركىلىش
يۇمرۇن=يۇمران
قىمماق=قىلماق
تەسەللىپ=تەسەللى
بىلگىڭىز=بىلگۈڭىز
جارائەت=جاراھەت
ھۆزۇرلىناتتىم=ھۇزۇرلىناتتىم
يۇتۇۋەتتىن=يۇتۇۋەتتىم
چۈشۈنۈۋاتامسىز=چۈشىنىۋاتامسىز
قەرىزدار=قەرزدار
قوشمىلىرىڭىزنى=قوشۇمىلىرىڭىزنى
رەخمەتلىرىم=رەھمەتلىرىم
قارىڭە=قاراڭە
ئەسىرەۋاتامسىز=ئەنسىرەۋاتامسىز
داۋەتقان=دەۋاتقان
تۆگكەن=تۆككەن
ئازابلايتى=ئازابلايتتى
مەغلۇبىيەتت=مەغلۇبىيەت
كاممۇنىست=كوممۇنىست
ئاتا-ئانسىسىنىڭ=ئاتا-ئانىسىنىڭ
تاموژنىزىسىدىن=تاموژنىسىدىن
كاممۇنىس=كوممۇنىست
شىلەر=سىلەر
پېرزىدەنت=پرېزىدېنت
ئامېرىكىقا=ئامېرىكىغا
توموژنىدىن=تاموژنىدىن
كىرگەزمەيدىغان=كىرگۈزمەيدىغان
ئەمەللەشتۈرىدىغان=ئەمەلىيلەشتۈرىدىغان
ھايدايدىكەن=ھەيدەيدىكەن
قاراشىچە=قارىشىچە
ھايدىۋېتىشى=ھەيدىۋېتىشى
ئەمەللەشمەيدۇ=ئەمەلىيلەشمەيدۇ
ئىكك=ئىككى
پرېزىدەنت=پرېزىدېنت
رۇرامپ=تىرامپ
كامۇنىست=كوممۇنىست
ئوتتۇراقلىشىپ=ئولتۇراقلىشىپ
پارتىيىسىغا=پارتىيەسىگە
ئوتتۇراقلاشقان=ئولتۇراقلاشقان
ئىستراتېگەيەلىك=ئىستراتېگىيەلىك
ساياھاتقا=ساياھەتكە
دۆۋلىتىدە=دۆلىتىدە
كامىنىست=كوممۇنىست
شايىكىرلىرىغا=شايكىلىرىغا
تۇرامپ=تىرامپ
كوممىنىست=كوممۇنىست
دۆۋلەتلەرنى=دۆلەتلەرنى
بولغۇپ=بوغۇپ
تېبەت=تىبەت
دەسسەندە=دەپسەندە
دەۋلەتلىرى=دۆلەتلىرى
كەممەكچى=كەلمەكچى
كىرگەزمەسلىك=كىرگۈزمەسلىك
بىڭتۇانلەرنى=بىڭتۇەنلەرنى
ئۆتكۈرلۈشۈپ=ئۆتكۈرلىشىپ
ئايرىقسامچۇ=ئايرىلسامچۇ
قىلۋېرەتتىم=قىلىۋېرەتتىم
پلانىتلار=پلانېتىلار
كەلتۈرۈشم=كەلتۈرۈشۈم
ھۆجەيرىلىرىممۇ=ھۈجەيرىلىرىممۇ
سەۋەرچى=سەۋەبچى
تىختىم=تىقتىم
گۈزەلاي=گۈزەلئاي
پاراڭلاشماقچىتىم=پاراڭلاشماقچىدىم
سىرقا=سىرتقا
پۈلىدى=پۈۋلىدى
بىدەن=بىلەن
قىراپ=قاراپ
تىنىقلىر=تىنىقلىرى
تونۇيالغان=تونۇيالىغان
ئۇزۇرۇشى=ئۇزىرىشى
تەييالا=تەييارلا
شەرپى=شەرىپى
تۇتۇۋىلغان=تۇتۇۋالغان
تىكىلىگەن=تىكىلگەن
ئاھۋالىڭىز=ئەھۋالىڭىز
ھۆجەتنى=ھۆججەتنى
پاكىتلەرنى=پاكىتلارنى
ئۇزۇڭىز=ئۆزىڭىز
ئىڭلىزچىغا=ئىنگلىزچىغا
ئاڭلىتتىمىز=ئاڭلىتىمىز
ھارارەستسىز=ھارارەتسىز
رېستۇراننىڭ=رېستوراننىڭ
ئارىلىش=ئارىلاش
ئۇچتۇۋەتسەم=ئوشتۇۋەتسەم
رېستۇراننى=رېستوراننى
گېزىتخاندىكىلەرنى=گېزىتخانىدىكىلەرنى
كېپىپ=كېلىپ
باياتتىن=باياتىن
گالستۇكوم=گالستۇكۇم
قىڭغار=قىڭغىر
گالاستۇكىنى=گالستۇكىنى
پىچىرلىۋېتدى=پىچىرلىۋېدى
ئولتۇرخانلارنىڭ=ئولتۇرغانلارنىڭ
نەسەر=نەزەر
ئۈلگىرىشتى=ئۈلگۈرۈشتى
كىيىملى=كىيىملىك
بومايدى=ھومايدى
ئەركۈننى=ئەركىننى
ماكنىت=ماگنىت
قالىپتۇ=قېلىپتۇ
قالتى=قالدى
قارىۋېتى=قارىۋېتىپ
كەلكەندە=كەلگەندە
بىكەر=بىكار
لەقىمۇ=لەقىمى
لەققىمىنى=لەقىمىنى
ئۇتۇلدا=ئۇدۇلدا
ئولتۇرىغان=ئولتۇرغان
ئۈستىدىگە=ئۈستىلىگە
قىپقىزى=قىپقىزىل
رېستۇرانىمىزغا=رېستورانىمىزغا
تەشۈرىپ=تەشرىپ
ئاچچىق-چۇچىكىنى=ئاچچىق-چۈچۈكىنى
ئەينەكى=ئەينىكى
دېيدىكەن=دەيدىكەن
پېدە=پەدە
پىرقاراپ=پىرقىراپ
ھەممەلەن=ھەممەيلەن
ئېلېكترنلۇق=ئېلېكترونلۇق
رومىكىنى=رومكىنى
رېستۇرانىمىز=رېستورانىمىز
تېلەۋىزورىدا=تېلېۋىزورىدا
مەكتىپ=مەكتەپ
ھەسسەت=ھەسەت
تەبەسسىم=تەبەسسۇم
تەسسادىپىيلىقتىن=تاسادىپىيلىقتىن
ئىتتىرىگىنىچە=ئىتتەرگىنىچە
چاغتا=چاغدا
گوركى=گوركىي
ئۇسسۇقچى=ئۇسسۇلچى
ئىشتىم=ئىچتىم
يىگىتتى=يىگىتى
غۇدىراپمۇ=غۇدۇراپمۇ
ئەتتىرنىڭ=ئەتىرنىڭ
غىداقلايدىغان=غىدىقلايدىغان
كەتكەتتىڭىزمۇ=كېتەتتىڭىزمۇ
نادېرىنىڭ=نادىرەنىڭ
تۇيغۇلاغا=تۇيغۇلارغا
ئەركىڭە=ئەركىنگە
قىزغىم=قىزغىن
چاقىرتىم=چاقىرتتىم
ئابدۇللاھ=ئابدۇللا
تەھمىن=تەخمىن
ئىشخانى=ئىشخانا
ئورۇنلارى=ئورۇنلار
كىرگۈزىلدى=كىرگۈزۈلدى
دىمىقىنى=دىمىغىنى
پۈتتۈرىپ=پۈتتۈرۈپ
مۇھەررەرلىك=مۇھەررىرلىك
قاتىر=قادىر
سۇغىرىۋالغۇدەك=سۇغۇرۇۋالغۇدەك
گوڭشىسىغا=گۇڭشېسىغا
بېردى=بەردى
لەڭمېنىنى=لەڭمىنىنى
يەتكەپ=يۆتكەپ
ئۈرۈمچىلە=ئۈرۈمچىدە
ئاپدۇللاغا=ئابدۇللاغا
نەھكەم=مەھكەم
بەلگىلىپ=بەلگىلەپ
تۆلىشكىمۇ=تۆلەشكىمۇ
بولۇشىڭ=بولۇشۇڭ
كەلدىڭىژمۇ=كەلدىڭىزمۇ
پاتگۈلنىڭ=پاتىگۈلنىڭ
خوسسىنغان=خورسىنغان
پاتىگېننىڭ=پاتىگۈلنىڭ
ناھلە=نالە
نېجىس=نىجىس
بۈۋۈم=بۈۋىم
رۇداپايدەك=رودۇپايدەك
بېكرەك=بەكرەك
ئىرىقچىلىق=ئىرقچىلىق
ئاكادىمىكىلار=ئاكادېمىكلار
ئاناسلىزچىلارغا=ئانالىزچىلارغا
خىتايىي=خىتاي
ئەيىبلىشتە=ئەيىبلەشتە
ژورنالىستلارنى=ژۇرنالىستلارنى
تەتتىقاتچى=تەتقىقاتچى
ژورنالىسلار=ژۇرنالىستلار
ختاي=خىتاي
ئىرىقچىلىقتىن=ئىرقچىلىقتىن
توگرىسىدىكى=توغرىسىدىكى
ئۇنىۋېرستەت=ئۇنىۋېرسىتېت
ئوكسفورت=ئوكسفورد
ژورنىلىدىكى=ژۇرنىلىدىكى
شەك-شۈھبە=شەك-شۈبھە
جېمئىيىتى=جەمئىيىتى
قەتئىينزەر=قەتئىينەزەر
مۇنۇسىۋەتلىك=مۇناسىۋەتلىك
تەربىيەسە=تەربىيەسى
ئىدەولوگىيىدە=ئىدېئولوگىيەدە
ئېتراپىغا=ئېتىراپىغا
ئوبزارچىلار=ئوبزورچىلار
ئىسلاھەت=ئىسلاھات
دېموگراتىك=دېموكراتىك
دېموكراتلىك=دېموكراتىك
دۆلىتلەرنىڭ=دۆلەتلەرنىڭ
قارشىلىقلىرنى=قارشىلىقلىرىنى
رىجىملار=رېجىملار
ھاكىمىيەتدىكى=ھاكىمىيەتتىكى
ئاۋم=ئاۋام
پاتىيەدىكى=پارتىيەدىكى
دېموكراتىيىلىشىشىنى=دېموكراتىيەلىشىشىنى
مىلىتارىسلارغا=مىلىتارىستلارغا
دېكتاتورلۇق=دىكتاتورىلىق
ناتسىس=ناتسىست
مۇتەپەكۈرلەرنى=مۇتەپەككۇرلارنى
دېكتاتورلىققا=دىكتاتورىلىققا
تىلىۋەزىيەسىنىڭ=تېلېۋىزىيەسىنىڭ
پروگرامسىغا=پروگراممىسىغا
ئوتتۇزۇنچى=ئوتتۇزىنچى
قانۇنلاردى=قانۇنلاردا
قويتۇرۇپ=قايتۇرۇپ
جورنىلىنىڭ=ژۇرنىلىنىڭ
ھىندونوزىيەلىكلەرنى=ھىندونېزىيەلىكلەرنى
سۆزىدې=سۆزىدە
رامىزاندا=رامزاندا
ھىندونوزىيە=ھىندونېزىيە
تاشق=تاشقى
ئىشىلار=ئىشلار
ختايغا=خىتايغا
خاتاينى=خىتاينى
ھىندونزىيىلىكلەر=ھىندونېزىيەلىكلەر
مىيونخېن=ميۇنخېن
ھەپتىرلىكى=ھەپتىلىكى
مىيونخېندىكى=ميۇنخېندىكى
ھەپتىلىدىكى=ھەپتىلىكى
سۈرۈشچە=سۈرۈشىچە
فېدەراتسىيە=فېدېراتسىيە
ئۆكتىچىلە=ئۆكتىچىلەر
مەجبۇرلۇشتەك=مەجبۇرلاشتەك
پائالىيتچىلىرىمىزنى=پائالىيەتچىلىرىمىزنى
بايرامىمىزنى=بايرىمىمىزنى
بالكىنلىرىغا=بالكونلىرىغا
يۇلتۇزۇق=يۇلتۇزلۇق
ئىستىقال=ئىستىقلال
يەككى=يەككە
كۇرۇپپىلارغا=گۇرۇپپىلارغا
نۇرماللاشقان=نورماللاشقان
مارچىمىزنى=مارشىمىزنى
مارشا=مارشى
مىقىياسىدا=مىقياسىدا
تۆۋەندې=تۆۋەندە
دەققىتىڭلار=دىققىتىڭلار
كومىسيون=كومىسسىيون
ئېتىباران=ئېتىبارەن
مونبىرى=مۇنبىرى
قۇرلىتىيى=قۇرۇلتىيى
تەشكىلاتىلار=تەشكىلاتلار
گۇۋانلىقلارنى=گۇۋاھلىقلارنى
ئايىرىپ=ئايرىپ
ئىنگىزچىغا=ئىنگلىزچىغا
سىستىملىق=سىستېمىلىق
ئىنگلىزچىگە=ئىنگلىزچە
پۇرساتنى=پۇرسەتنى
بىرىچى=بىرىنچى
تاپشۇرۇلدىغان=تاپشۇرۇلىدىغان
دېلىل=دەلىل
تۈرملەرگە=تۈرمىلەرگە
مال-مۈلۈكۈنى=مال-مۈلكىنى
ساقتىسى=ساختىسى
كەيەنكى=كېيىنكى
كۈرۈشەيلى=كۆرۈشەيلى
ئاغىينەم=ئاغىنەم
ئەدەملەرگە=ئادەملەرگە
يورغلىتىدۇ=يورغىلىتىدۇ
پرىزىدەنتىنى=پرېزىدېنتىنى
دوپىمىزنى=دوپپىمىزنى
ژۇرماللارنى=ژۇرناللارنى
دەۋلەتلەرنىڭكى=دۆلەتلەرنىڭكى
ئۈلگۈسى=ئۈلگىسى
سىغامدا=سىغامدۇ
ئىشەنجىم=ئىشەنچىم
مۇشۇندا=مۇشۇنداق
قانۇنلاغا=قانۇنلارغا
قانۇنلانى=قانۇنلارنى
پرېزدېنتتىن=پرېزىدېنتتىن
پارلامېتتىن=پارلامېنتتىن
پارلامىنىتىنىڭ=پارلامېنتىنىڭ
قامۇن=قانۇن
كەلگچە=كەلگۈچە
پارلامىنتىن=پارلامېنتتىن
پرىزدىنت=پرېزىدېنت
چىقادى=چىقاردى
قۇشۇلمىسا=قوشۇلمىسا
تېررورجى=تېررورچى
تەربىيلەۋاتىمىز=تەربىيەلەۋاتىمىز
بىمېنىلىك=بىمەنىلىك
تارىھنى=تارىخنى
توساشنى=توسۇشنى
تېررورزىمنى=تېررورىزمنى
ئىقتىساتتا=ئىقتىسادتا
ئىقتىساددە=ئىقتىسادتا
قىلىۋتىپسىلەر=قىلىۋېتىپسىلەر
ئادەمەە=ئادەمگە
ئاۋۋاز=ئاۋاز
بەرسەن=بەرسەم
ئاسىياسىدىكى=ئاسىيادىكى
ئۆتۈدۇ=ئۆتىدۇ
ئامېرىكادىكى=ئامېرىكىدىكى
ۋاشىنگېتوندىن=ۋاشىنگتوندىن
تۆۋەندىكۈدەك=تۆۋەندىكىدەك
خەۋەرلار=خەۋەرلەر
خەۋەرلە=خەۋەرلەر
پروگراملار=پروگراممىلار
دىقىتىڭلاردا=دىققىتىڭلاردا
تەربىيەلىش=تەربىيەلەش
تۇتقىننىڭ=تۇتقۇننىڭ
كاپالەتتىكە=كاپالەتكە
يۇقىرىقا=يۇقىرىقى
تۈركىتسان=تۈركىستان
تۈركسان=تۈركىستان
تەشكىلاتلىر=تەشكىلاتلىرى
كۈزەتكۈچىلەردە=كۆزەتكۈچىلەردە
كارخانىلىرغا=كارخانىلىرىغا
پارتىلغان=پارتلىغان
مەنبەسىگى=مەنبەسىگە
نەپرى=نەپىرى
ئەشكارىلاندى=ئاشكارىلاندى
ئىشلەپچىقىرىغانلىقىنى=ئىشلەپچىقىرىلغانلىقىنى
تۈزۈمىگەنلىكىنى=تۈزمىگەنلىكىنى
تاكىتلىگەن=تەكىتلىگەن
تېيرىرلىغان=تەييارلىغان
پىرگراممىلار=پروگراممىلار
دەققىتىڭلاردا=دىققىتىڭلاردا
ھىندورىزىيە=ھىندونېزىيە
ئىندونېزىيەدە=ھىندونېزىيەدە
سەبدىشىنى=سەپدىشىنى
سۆھرەت=شۆھرەت
شۆھبەت=سۆھبەت
دوختۇرخانىا=دوختۇرخانىدا
ئىگىللىنىشىچە=ئىگىلىنىشىچە
ئىستانبولدىكى=ئىستانبۇلدىكى
تۇركستان=تۈركىستان
خۇپتەڭىچە=خۇپتەنگىچە
ئەھالى=ئەھۋالى
مۇتخەسسىسلىرى=مۇتەخەسسىسلىرى
دوختۇرغانىغا=دوختۇرخانىغا
خەۋىپكە=خەۋپكە
ۋىراچى=ۋراچى
شەققىدە=ھەققىدە
ئەسالام=ئەسسالام
قىينانغانلىق=قىينالغانلىق
سائەتت=سائەت
نەۋەتلىشىپ=نۆۋەتلىشىپ
يۇسۇپجان=يۈسۈپجان
ئىجمائىي=ئىجتىمائىي
سۆيگىسىنى=سۆيگۈسىنى
يىشايدىغان=ياشايدىغان
ئەھۋاللىاردا=ئەھۋاللاردا
فەيىسبۇك=فېيىسبۇك
مەنبەرلىرىدە=مەنبەلىرىدە
بولغاچتا=بولغاچقا
ماھاجىرەتتىكى=مۇھاجىرەتتىكى
فەيىسبۇكقا=فېيىسبۇكقا
ياپۇنىيەدىكى=ياپونىيەدىكى
جاۋلان=جەۋلان
تەلتۆكۈش=تەلتۆكۈس
قېدىمىنى=قەدىمىنى
تەل-تۆكۈس=تەلتۆكۈس
خىتتاينىڭكى=خىتاينىڭكى
قىرغانچىلىقىنى=قىرغىنچىلىقىنى
بىزىڭكى=بىزنىڭكى
شۆزىنىڭ=سۆزىنىڭ
قىرغىچىلىقىغا=قىرغىنچىلىقىغا
سەرقىي=شەرقىي
شۈرىيە=سۈرىيە
قارباغ=قاراباغ
پرېزدەنتى=پرېزىدېنتى
ئۇنداقدا=ئۇنداقتا
يىغاندە=يىغىندا
قاراشلارىنى=قاراشلارنى
رەبەرلىرى=رەھبەرلىرى
قىلالايدىغانلىقىگا=قىلالايدىغانلىقىغا
پرېزدىنتى=پرېزىدېنتى
زىياىتىمىزنى=زىيارىتىمىزنى
ئۇنۋېرىستېتى=ئۇنىۋېرسىتېتى
تۈركلەنىڭكى=تۈركلەرنىڭكى
بولسۇم=بولسۇن
سىپروستا=سىپرۇستا
ئۆزگرەمدۇ=ئۆزگىرەمدۇ
خىتايىنىڭكى=خىتاينىڭكى
پرىزدېنتلىق=پرېزىدېنتلىق
دىققېتىڭلاردا=دىققىتىڭلاردا
يۈرگۇزۇۋاتقان=يۈرگۈزۈۋاتقان
قۇتۇلۇقش=قۇتۇلۇش
قازىقىستاندىكى=قازاقىستاندىكى
تاماممىغان=تاماملىغان
سۇغۇللانغان=شۇغۇللانغان
ئەلۋەتتەن=ئەلۋەتتە
مولدۇزنى=موزدۇزنى
كەچقۇران=كەچقۇرۇن
ئاغىزىڭنى=ئېغىزىڭنى
سۆرىۋاتقان=سۆرەۋاتقان
قىزسا=قىلسا
ئۇرۇق-تۇققانلىرىنى=ئۇرۇق-تۇغقانلىرىنى
تىچلاندۇرۇپ=تىنچلاندۇرۇپ
سۇكۇناتتا=سۈكۈناتتا
تىيانشان=تيانشان
ۋىنگىرىيىلىك=ۋېنگىرىيەلىك
ۋىنگىرىيىلىكلەرنىڭ=ۋېنگىرىيەلىكلەرنىڭ
كوئىنلۇن=كۇئىنلۇن
بىلېكى=بىلىكى
گىرادوستىن=گرادۇستىن
ئېكىسپېدىتسىيىچى=ئېكسپېدىتسىيەچى
قورت=قۇرت
غۇچورلىتىپ=غۇچۇرلىتىپ
گارمۇنغا=گارمونغا
يادرۇ=يادرو
كۇتۇبخانىسىنىڭ=كۇتۇپخانىسىنىڭ
مۆڭگۈزى=مۈڭگۈزى
چۇماقچىلىرىنى=چوماقچىلىرىنى
قۇرىماقتا=قۇرۇماقتا
مۇلۇنلارنىڭ=مولۇنلارنىڭ
تىيانشاننىڭ=تيانشاننىڭ
قۇيرىقى=قۇيرۇقى
پەسلگە=پەسىلگە
دەرخلەر=دەرەخلەر
تەسادىپى=تاسادىپىي
تىيەنجىننىڭ=تيەنجىننىڭ
ئادىمىزاتسىز=ئادەمزاتسىز
شىۋىتسىيىلىك=شىۋېتسىيەلىك
گرادۇسىدىكى=گرادۇستىكى
ئوچۇشۇۋاتقان=ئۇچۇشۇۋاتقان
چۆل-چەزىرە=چۆل-جەزىرە
ئۇچچىدىن=ئۇچىدىن
تىيانشاندا=تيانشاندا
ئولانباتۇردا=ئۇلانباتوردا
ئېكسپېدىتسىيىچىلەرگە=ئېكسپېدىتسىيەچىلەرگە
مىلىتىقى=مىلتىقى
كۈزەتكەن=كۆزەتكەن
قېلىقلىرىدىن=قىلىقلىرىدىن
زۇقلانغان=زوقلانغان
مەرتلىكىنى=مەردلىكىنى
ئېلىشىتى=ئېلىشتى
بۇيۇن=بويۇن
ئىنگلىزلەر=ئىنگلىزلار
ترانسىپورتتا=ترانسپورتتا
كۆتىرەلىشى=كۆتۈرەلىشى
ئوچار=ئۇچار
ئوسسۇزلۇقتىن=ئۇسسۇزلۇقتىن
چىغىدىكىگە=چېغىدىكىگە
شۋىتسىيەلىك=شىۋېتسىيەلىك
ئوپۇققا=ئۇپۇققا
ئېكىسپېدىتسىيىچىلەر=ئېكسپېدىتسىيەچىلەر
ئوسلۇبتا=ئۇسلۇبتا
ماتىماتىكىچى=ماتېماتىكىچى
گۆركىرىگەن=گۈركىرىگەن
پىقىراپ=پىرقىراپ
ھوۋلىشى=ھۇۋلىشى
مېھرىگىيا=مېھرىگىياھ
ياڭيوغا=ياڭيۇغا
ھاشارەتخور=ھاشاراتخور
دۈۋىسىدىن=دۆۋىسىدىن
مەىلىمۇ=مەيلىمۇ
سۇيگۇنىمگە=سۆيگۈنۈمگە
ئاكىمىنسىز=ئاكىمىز
ئىتتىرىۋاتقىنىدەك=ئىتتىرىۋاتقاندەك
سۆرەۋاتقىنىدەك=سۆرەۋاتقاندەك
قەبىمدىكى=قەلبىمدىكى
مەزمۇللار=مەزمۇنلار
ئىسكرىپكىلارنىڭ=ئىسكىرىپكىلارنىڭ
ساياھىيىتىمىزدە=ساياھىتىمىزدە
جيەجياڭ=جېجياڭ
ئۈسكىنە=ئۈسكۈنە
شەھلىنى=شەكلىنى
شەكلدە=شەكىلدە
مۇمكىنچىلىقىنى=مۇمكىنچىلىكىنى
كەسىپىنىڭ=كەسپىنىڭ
ئىشلەشكۈچە=ئىشلەشكىچە
لايىھىيەلىگەن=لايىھىلىگەن
ئىجاتچانلىقىمنى=ئىجادچانلىقىمنى
يەيدۇرۇپ=يايدۇرۇپ
باشلىلدى=باشلىدى
مەكتەپلارنىڭ=مەكتەپلەرنىڭ
كوللېكتىپىگە=كوللېكتىپىغا
رەرقەملەشتۈرۈلگەن=رەقەملەشتۈرۈلگەن
پارامېتلىرىنى=پارامېتىرلىرىنى
يولانما=يوللانما
تۆلىشىمى=تۆلىشىمنى
يولانمىلارنىڭ=يوللانمىلارنىڭ
يولانمىلارنى=يوللانمىلارنى
يولانمىنىڭ=يوللانمىنىڭ
مەھەلىلەگە=مەھەللىلەرگە
پۇنى=پۇلنى
ئوبروتىنىڭ=ئوبوروتىنىڭ
ئوبورتى=ئوبوروتى
ئەشي=ئەشيا
ئوبروتىنى=ئوبوروتىنى
تەمىنلەس=تەمىنلەش
ئۈسكىنىسىنىڭ=ئۈسكۈنىسىنىڭ
ئۇبورتى=ئوبوروتى
ئۇمۇملىشىدۇ=ئومۇملىشىدۇ
ئەلىكتىر=ئېلېكتر
ئىگىلىنىشچا=ئىگىلىنىشىچە
ترانسپور=ترانسپورت
يولانمىنى=يوللانمىنى
سۈرئەتتىك=سۈرئەتلىك
ھالىقىسىغا=ھالقىسىغا
ئەمدىزىسى=ئەندىزىسى
ئاپلوماتلىشىش=ئاپتوماتلىشىش
يۇغۇرلۇشى=يۇغۇرۇلۇشى
تەننەرىخى=تەننەرخى
بەسبەستە=بەس-بەستە
ئۇسكىنىلىرىنىڭ=ئۈسكۈنىلىرىنىڭ
پىرسەنتىن=پىرسەنتتىن
پۇسۇلكىنى=پوسۇلكىنى
دېرىجىسىنى=دەرىجىسىنى
بايرىم=بايرىمى
ئوبورت=ئوبوروت
مۆلدىن=نۆلدىن
ئىستېماتچىلار=ئىستېمالچىلار
ئېلەكترونلۇق=ئېلېكترونلۇق
يۈزلۈنۈشى=يۈزلىنىشى
ئېلېچترونلۇق=ئېلېكترونلۇق
سەھەبىدىن=سەۋەبىدىن
مالۇماتىدا=مەلۇماتىدا
مىليۈن=مىليون
كۆرسىتىستىن=كۆرسىتىشتىن
قىسمىغ=قىسمىغا
تەقەققىي=تەرەققىي
ئېلېكترولۇق=ئېلېكترونلۇق
ھەمكاھلىقىنى=ھەمراھلىقىنى
يەردا=يەردە
گۈزالنۇر=گۈزەلنۇر
ھەير=خەير
ئېلىۋەلىڭلار=ئېلىۋېلىڭلار
جېددىي=جىددىي
شېرىڭۈل=شېرىنگۈل
ئەسسەر=ئەسەر
دېمىق=دىمىق
ئەسلىملىرىمىز=ئەسلىمىلىرىمىز
ئولتۇرغاندۇق=ئولتۇرغانتۇق
ۋاقىرىۋەتتى=ۋارقىرىۋەتتى
قايغۇسنى=قايغۇسىنى
تاماقخاننىڭ=تاماقخانىنىڭ
چاپىلىنىڭ=چاپىنىنىڭ
دەۋىرىگە=دەۋرىگە
قىمارۋاس=قىمارۋاز
يۇمۇرىسىتىك=يۇمۇرىستىك
چۈشەڭەندىن=چۈشەنگەندىن
ئاڭلغۇچىلىرىمىز=ئاڭلىغۇچىلىرىمىز
لامپۈچكا=لامپۇچكا
قەۋۋەتكە=قەۋەتكە
چىقىسىغا=چىقىشىغا
كۈيلۈرىمىز=كۈيلىرىمىز
ئاڭلىھۇچى=ئاڭلىغۇچى
پروگرامىمىزنى=پروگراممىمىزنى
مېھر=مېھىر
پەللىگى=پەللىگە
ئىستانسىسىمىزنىڭ=ئىستانسىمىزنىڭ
يۈزىلىنەلىگەن=يۈزلىنەلىگەن
كۆزىگەن=كۆزلىگەن
ئۇرۇغۇپ=ئۇرغۇپ
سۈيۈشىگە=سۆيۈشىگە
سۈيگۈ=سۆيگۈ
مەنىلەرغا=مەنىلەرگە
كۆڭلۈمىزدىن=كۆڭلىمىزدىن
سوغاتلارنى=سوۋغاتلارنى
جارىيانلىرىدا=جەريانلىرىدا
مەنەدىن=مەنىدىن
تۇرمۇشۇنىڭ=تۇرمۇشىنىڭ
بىيىغام=بېيىغان
قىلالمايىدىغان=قىلالمايدىغان
تېزلىقىدىن=تېزلىكىدىن
قىممىتتى=قىممىتى
مۇھازىرەتتىكى=مۇھاجىرەتتىكى
ئادىئونىڭ=رادىئونىڭ
ئوينادۇ=ئوينايدۇ
ئەنەنىلىەر=ئەنئەنىلەر
خوشنىلار=قوشنىلار
خوشنىسىغا=قوشنىسىغا
خوشنىلا=قوشنىلا
خوشنىنىڭ=قوشنىنىڭ
ئارقىلۇق=ئارقىلىق
پىيالدىكى=پىيالىدىكى
قوشۇندارچىلىقىدىكى=قوشنىدارچىلىقىدىكى
قۇشاقلىرىنى=قوشاقلىرىنى
خەلقلىرىغا=خەلقلىرىگە
فەمىلە=فامىلە
بۇۋەقتەك=بوۋاقتەك
جىھەتلەردىن=جەھەتلەردىن
دائىرىمنى=دائىرەمنى
كېلىچەكتە=كېلەچەكتە
كەسىپىنى=كەسپىنى
دېيمىز=دەيمىز
كەسىپىدە=كەسپىدە
نىسبەتتەن=نىسبەتەن
مۈشۈكۈل=مۈشكۈل
كېلچەكتە=كېلەچەكتە
ھوقۇقىم=ھوقۇقۇم
ئۆگۈنەلەيدۇ=ئۆگىنەلەيدۇ
ئۈزۈگە=ئۆزىگە
جەۋەتلەردە=جەھەتلەردە
نۇتىقىنى=نۇتقىنى
ئۇسۇلۇبىغا=ئۇسلۇبىغا
دوكتۇرلۇقنى=دوكتورلۇقنى
ماتېريالللاردىن=ماتېرىياللاردىن
ئىشتىرەق=ئىشتىراك
يۈتىك=يېتۈك
چولپانىمىز=چولپىنىمىز
مەدىيەلىرى=مەدھىيەلىرى
غوجانىياز=خوجىنىياز
پوسىتسىيەسىنى=پوزىتسىيەسىنى
مەغلۇپىيەت=مەغلۇبىيەت
تاكرار=تەكرار
داۋانلادا=داۋانلاردا
قالدا=قالدى
ئارسىلانلار=ئارسلانلار
دەشتە-چۆلدە=دەشت-چۆلدە
قەبىرسىز=قەبرىسىز
يۇغۇن=يۇلغۇن
ئاسايىسلىق=ئاسايىشلىق
ئەلىپببە=ئېلىپبە
قوشۇپلۇپ=قوشۇلۇپ
